//MAP CONVERTED BY dmm2tgm.py THIS HEADER COMMENT PREVENTS RECONVERSION, DO NOT REMOVE
"a" = (
/obj/effect/mapping_helpers/no_lava,
/turf/simulated/floor/plating/asteroid/basalt/lava_land_surface,
/area/lavaland/surface/outdoors)
"b" = (
/obj/structure/stone_tile/surrounding/cracked,
/obj/structure/lightable/torch/lava_bridge,
/obj/effect/mapping_helpers/no_lava,
/turf/simulated/floor/plating/asteroid/basalt/lava_land_surface,
/area/lavaland/surface/outdoors)
"c" = (
/obj/structure/stone_tile{
	dir = 4
	},
/obj/structure/stone_tile{
	dir = 8
	},
/obj/structure/stone_tile{
	dir = 1
	},
/obj/item/flashlight/lantern,
/obj/effect/mapping_helpers/no_lava,
/turf/simulated/floor/plating/asteroid/basalt/lava_land_surface,
/area/lavaland/surface/outdoors)
"d" = (
/obj/structure/stone_tile/block{
	dir = 4
	},
/obj/effect/mapping_helpers/no_lava,
/turf/simulated/floor/plating/asteroid/basalt/lava_land_surface,
/area/lavaland/surface/outdoors)
"e" = (
/obj/structure/stone_tile/slab,
/obj/structure/shelf/wood,
/obj/item/flashlight/flare,
/obj/item/pickaxe/bone,
/obj/item/mining_scanner,
/obj/effect/spawner/random/common_ore,
/obj/effect/mapping_helpers/no_lava,
/turf/simulated/floor/plating/asteroid/basalt/lava_land_surface,
/area/lavaland/surface/outdoors)
"f" = (
/mob/living/basic/mining/goliath,
/obj/effect/mapping_helpers/no_lava,
/turf/simulated/floor/plating/asteroid/basalt/lava_land_surface,
/area/lavaland/surface/outdoors)
"g" = (
/obj/structure/stone_tile/block{
	dir = 8
	},
/obj/effect/mapping_helpers/no_lava,
/turf/simulated/floor/plating/asteroid/basalt/lava_land_surface,
/area/lavaland/surface/outdoors)
"h" = (
/obj/structure/stone_tile{
	dir = 4
	},
/obj/structure/stone_tile{
	dir = 8
	},
/obj/structure/stone_tile,
/obj/structure/closet/crate/necropolis,
/obj/effect/spawner/random/common_ore,
/obj/effect/spawner/random/common_ore,
/obj/effect/mapping_helpers/no_lava,
/turf/simulated/floor/plating/asteroid/basalt/lava_land_surface,
/area/lavaland/surface/outdoors)
"i" = (
/obj/structure/barricade/wooden/crude,
/obj/effect/mapping_helpers/no_lava,
/turf/simulated/floor/plating/asteroid/basalt/lava_land_surface,
/area/lavaland/surface/outdoors)
"l" = (
/obj/structure/stone_tile/slab,
/obj/structure/bed/dirty,
/obj/item/bedsheet,
/obj/effect/mapping_helpers/no_lava,
/turf/simulated/floor/plating/asteroid/basalt/lava_land_surface,
/area/lavaland/surface/outdoors)
"m" = (
/obj/structure/stone_tile/block{
	dir = 1
	},
/obj/effect/mapping_helpers/no_lava,
/turf/simulated/floor/plating/asteroid/basalt/lava_land_surface,
/area/lavaland/surface/outdoors)
"n" = (
/turf/template_noop,
/area/template_noop)
"p" = (
/obj/structure/lightable/bonfire/lit,
/obj/effect/mapping_helpers/no_lava,
/turf/simulated/floor/plating/asteroid/basalt/lava_land_surface,
/area/lavaland/surface/outdoors)
"q" = (
/obj/structure/chair/stool/wood{
	pixel_x = 5
	},
/obj/effect/mapping_helpers/no_lava,
/turf/simulated/floor/plating/asteroid/basalt/lava_land_surface,
/area/lavaland/surface/outdoors)
"r" = (
/obj/item/reagent_containers/glass/bucket/wooden,
/obj/effect/mapping_helpers/no_lava,
/turf/simulated/floor/plating/asteroid/basalt/lava_land_surface,
/area/lavaland/surface/outdoors)
"s" = (
/obj/structure/stone_tile/block,
/obj/effect/mapping_helpers/no_lava,
/turf/simulated/floor/plating/asteroid/basalt/lava_land_surface,
/area/lavaland/surface/outdoors)
"t" = (
/obj/structure/chair/stool/wood,
/obj/effect/mapping_helpers/no_lava,
/turf/simulated/floor/plating/asteroid/basalt/lava_land_surface,
/area/lavaland/surface/outdoors)
"u" = (
/turf/simulated/wall/mineral/wood,
/area/lavaland/surface/outdoors)
"v" = (
/obj/structure/stone_tile/block{
	dir = 1
	},
/obj/effect/mapping_helpers/no_lava,
/obj/effect/mapping_helpers/no_lava,
/turf/simulated/floor/plating/asteroid/basalt/lava_land_surface,
/area/lavaland/surface/outdoors)
"x" = (
/obj/machinery/hydroponics/soil,
/obj/item/seeds/tower,
/obj/effect/mapping_helpers/no_lava,
/turf/simulated/floor/plating/asteroid/basalt/lava_land_surface,
/area/lavaland/surface/outdoors)
"z" = (
/obj/structure/grave,
/obj/effect/mapping_helpers/no_lava,
/turf/simulated/floor/plating/asteroid/basalt/lava_land_surface,
/area/lavaland/surface/outdoors)
"B" = (
/obj/structure/stone_tile,
/obj/structure/stone_tile{
	dir = 8
	},
/obj/effect/mapping_helpers/no_lava,
/turf/simulated/floor/plating/asteroid/basalt/lava_land_surface,
/area/lavaland/surface/outdoors)
"C" = (
/obj/structure/stone_tile/slab,
/obj/structure/table/wood,
/obj/item/clothing/suit/hooded/bone_light{
	pixel_x = -4;
	pixel_y = -3
	},
/obj/item/stack/sheet/bone{
	pixel_x = 12;
	pixel_y = 7
	},
/obj/effect/mapping_helpers/no_lava,
/turf/simulated/floor/plating/asteroid/basalt/lava_land_surface,
/area/lavaland/surface/outdoors)
"D" = (
/obj/structure/stone_tile/surrounding,
/obj/structure/lightable/torch/lava_bridge,
/obj/effect/mapping_helpers/no_lava,
/turf/simulated/floor/plating/asteroid/basalt/lava_land_surface,
/area/lavaland/surface/outdoors)
"E" = (
/obj/structure/stone_tile/slab/cracked,
/obj/effect/mapping_helpers/no_lava,
/turf/simulated/floor/plating/asteroid/basalt/lava_land_surface,
/area/lavaland/surface/outdoors)
"I" = (
/obj/structure/lightable/torch/lava_bridge,
/obj/structure/stone_tile/surrounding,
/obj/effect/mapping_helpers/no_lava,
/turf/simulated/floor/plating/asteroid/basalt/lava_land_surface,
/area/lavaland/surface/outdoors)
"K" = (
/turf/simulated/floor/lava/mapping_lava,
/area/lavaland/surface/outdoors)
"L" = (
/obj/structure/stone_tile/block/cracked,
/obj/effect/mapping_helpers/no_lava,
/turf/simulated/floor/plating/asteroid/basalt/lava_land_surface,
/area/lavaland/surface/outdoors)
"M" = (
/mob/living/basic/mining/hivelord/legion,
/obj/effect/mapping_helpers/no_lava,
/turf/simulated/floor/plating/asteroid/basalt/lava_land_surface,
/area/lavaland/surface/outdoors)
"N" = (
/obj/machinery/hydroponics/soil,
/obj/item/seeds/glowshroom,
/obj/effect/mapping_helpers/no_lava,
/turf/simulated/floor/plating/asteroid/basalt/lava_land_surface,
/area/lavaland/surface/outdoors)
"O" = (
/obj/structure/stone_tile/slab,
/obj/effect/mapping_helpers/no_lava,
/turf/simulated/floor/plating/asteroid/basalt/lava_land_surface,
/area/lavaland/surface/outdoors)
"Q" = (
/obj/effect/mob_spawn/human/corpse/random_species/miner,
/turf/simulated/floor/lava/mapping_lava,
/area/lavaland/surface/outdoors)
"R" = (
/obj/item/clothing/shoes/workboots/mining,
/turf/simulated/floor/plating/asteroid/basalt/lava_land_surface,
/area/lavaland/surface/outdoors)
"S" = (
/obj/structure/stone_tile/block/cracked{
	dir = 8
	},
/obj/effect/mapping_helpers/no_lava,
/turf/simulated/floor/plating/asteroid/basalt/lava_land_surface,
/area/lavaland/surface/outdoors)
"T" = (
/obj/structure/stone_tile/block/cracked{
	dir = 1
	},
/obj/effect/mapping_helpers/no_lava,
/turf/simulated/floor/plating/asteroid/basalt/lava_land_surface,
/area/lavaland/surface/outdoors)
"V" = (
/obj/structure/stone_tile/slab/cracked,
/obj/structure/stone_tile/slab/cracked,
/obj/effect/mapping_helpers/no_lava,
/turf/simulated/floor/plating/asteroid/basalt/lava_land_surface,
/area/lavaland/surface/outdoors)
"W" = (
/obj/item/cultivator/rake,
/obj/effect/mapping_helpers/no_lava,
/turf/simulated/floor/plating/asteroid/basalt/lava_land_surface,
/area/lavaland/surface/outdoors)
"Y" = (
/obj/structure/stone_tile/surrounding/burnt,
/obj/structure/lightable/torch/lava_bridge,
/obj/effect/mapping_helpers/no_lava,
/turf/simulated/floor/plating/asteroid/basalt/lava_land_surface,
/area/lavaland/surface/outdoors)
"Z" = (
/turf/simulated/mineral/volcanic/lava_land_surface,
/area/lavaland/surface/outdoors)

(1,1,1) = {"
n
n
n
n
n
n
n
n
n
n
n
n
a
a
n
n
n
n
n
n
"}
(2,1,1) = {"
n
n
n
n
n
n
n
n
n
n
n
a
a
a
n
n
n
n
n
n
"}
(3,1,1) = {"
n
n
n
n
n
n
n
Z
Z
n
a
a
a
a
a
Y
n
n
n
n
"}
(4,1,1) = {"
n
n
n
n
n
Z
Z
Z
Z
a
a
K
K
a
a
a
a
n
n
n
"}
(5,1,1) = {"
n
n
n
n
Z
Z
Z
Z
a
a
K
K
K
K
a
S
a
n
n
n
"}
(6,1,1) = {"
n
n
n
Z
Z
Z
Z
a
a
a
K
K
K
K
K
O
a
a
n
n
"}
(7,1,1) = {"
n
n
n
Z
Z
f
a
a
a
K
K
K
Q
K
K
a
O
L
n
n
"}
(8,1,1) = {"
n
n
Z
Z
a
a
a
a
a
a
K
K
R
K
a
S
E
a
a
n
"}
(9,1,1) = {"
n
Z
Z
Z
D
a
a
a
a
K
K
a
a
a
a
E
O
a
a
n
"}
(10,1,1) = {"
n
Z
Z
Z
a
a
a
a
a
a
a
a
a
g
E
E
s
a
a
a
"}
(11,1,1) = {"
n
Z
Z
a
a
a
a
a
a
a
a
a
O
E
s
a
a
a
f
a
"}
(12,1,1) = {"
n
Z
a
a
a
r
u
u
u
u
u
a
E
s
z
a
a
a
n
n
"}
(13,1,1) = {"
n
n
a
a
W
N
u
l
a
e
u
E
E
O
a
b
a
a
n
n
"}
(14,1,1) = {"
n
n
S
a
a
x
u
B
M
a
i
a
m
E
L
a
a
a
n
n
"}
(15,1,1) = {"
n
a
O
S
a
N
u
h
q
c
u
a
m
E
s
a
t
a
Z
Z
"}
(16,1,1) = {"
a
T
O
O
a
a
u
u
C
u
u
a
a
E
L
t
p
Z
Z
Z
"}
(17,1,1) = {"
n
a
T
E
L
a
a
u
u
u
a
v
O
O
n
a
Z
Z
Z
Z
"}
(18,1,1) = {"
n
I
a
a
O
E
a
a
a
a
g
E
V
n
n
Z
Z
Z
Z
Z
"}
(19,1,1) = {"
n
n
a
a
T
E
O
g
g
E
E
d
n
n
n
Z
Z
Z
Z
Z
"}
(20,1,1) = {"
n
n
n
n
n
d
d
E
E
d
a
n
n
n
n
Z
Z
n
Z
n
"}
