//MAP CONVERTED BY dmm2tgm.py THIS HEADER COMMENT PREVENTS RECONVERSION, DO NOT REMOVE
"a" = (
/turf/simulated/mineral/random/volcanic,
/area/space)
"b" = (
/obj/structure/stone_tile/surrounding_tile{
	dir = 8
	},
/turf/simulated/floor/plating/asteroid/basalt/lava_land_surface,
/area/space)
"d" = (
/obj/structure/stone_tile/surrounding_tile,
/turf/space,
/area/space)
"e" = (
/obj/structure/stone_tile/block{
	dir = 1
	},
/turf/space,
/area/space)
"f" = (
/obj/structure/stone_tile/surrounding_tile{
	dir = 1
	},
/turf/space,
/area/space)
"k" = (
/obj/structure/stone_tile/surrounding_tile{
	dir = 4
	},
/turf/space,
/area/space)
"l" = (
/obj/structure/stone_tile/cracked,
/turf/space,
/area/space)
"o" = (
/obj/structure/stone_tile/cracked{
	dir = 8
	},
/turf/space,
/area/space)
"p" = (
/obj/structure/stone_tile/block,
/turf/space,
/area/space)
"s" = (
/obj/structure/stone_tile/surrounding_tile{
	dir = 8
	},
/turf/space,
/area/space)
"t" = (
/obj/structure/stone_tile/block/cracked{
	dir = 4
	},
/turf/space,
/area/space)
"u" = (
/obj/structure/stone_tile/block{
	dir = 1
	},
/turf/simulated/floor/plating/asteroid/basalt/lava_land_surface,
/area/space)
"y" = (
/obj/structure/stone_tile/cracked{
	dir = 1
	},
/turf/space,
/area/space)
"z" = (
/obj/structure/stone_tile/surrounding_tile/cracked{
	dir = 4
	},
/turf/space,
/area/space)
"B" = (
/obj/structure/stone_tile/block/cracked{
	dir = 8
	},
/turf/simulated/floor/plating/asteroid/basalt/lava_land_surface,
/area/space)
"D" = (
/turf/space,
/area/space)
"E" = (
/obj/structure/stone_tile/surrounding_tile/cracked{
	dir = 1
	},
/turf/space,
/area/space)
"F" = (
/obj/structure/stone_tile/surrounding_tile/cracked{
	dir = 1
	},
/turf/simulated/floor/plating/asteroid/basalt/lava_land_surface,
/area/space)
"G" = (
/obj/structure/stone_tile/surrounding_tile{
	dir = 4
	},
/turf/simulated/floor/plating/asteroid/basalt/lava_land_surface,
/area/space)
"H" = (
/obj/structure/stone_tile/block/cracked{
	dir = 8
	},
/turf/space,
/area/space)
"I" = (
/mob/living/simple_animal/hostile/megafauna/fleshling,
/turf/space,
/area/space)
"J" = (
/obj/structure/stone_tile/surrounding_tile/cracked,
/turf/space,
/area/space)
"M" = (
/obj/structure/stone_tile/cracked{
	dir = 4
	},
/turf/simulated/floor/plating/asteroid/basalt/lava_land_surface,
/area/space)
"P" = (
/obj/structure/stone_tile/surrounding_tile,
/turf/simulated/floor/plating/asteroid/basalt/lava_land_surface,
/area/space)
"Q" = (
/obj/structure/stone_tile/surrounding_tile{
	dir = 8
	},
/obj/structure/stone_tile/surrounding_tile{
	dir = 1
	},
/turf/space,
/area/space)
"U" = (
/obj/structure/stone_tile/surrounding_tile/cracked{
	dir = 8
	},
/turf/space,
/area/space)
"X" = (
/obj/structure/stone_tile/surrounding_tile/cracked,
/turf/simulated/floor/plating/asteroid/basalt/lava_land_surface,
/area/space)

(1,1,1) = {"
a
a
a
a
a
a
a
a
a
a
a
a
a
a
a
a
a
a
a
D
a
a
a
a
a
a
a
a
a
a
a
a
a
a
a
a
a
a
a
"}
(2,1,1) = {"
a
a
a
a
a
a
a
a
a
a
a
a
a
a
a
a
a
a
a
D
a
a
a
a
a
a
a
a
a
a
a
a
a
a
a
a
a
a
a
"}
(3,1,1) = {"
a
a
a
a
a
a
a
a
a
a
a
a
a
a
a
a
a
a
a
D
a
a
a
a
a
a
a
a
a
a
a
a
a
a
a
a
a
a
a
"}
(4,1,1) = {"
a
a
a
a
a
a
a
a
a
a
a
a
a
a
a
a
a
a
a
D
a
a
a
a
a
a
a
a
a
a
a
a
a
a
a
a
a
a
a
"}
(5,1,1) = {"
a
a
a
a
a
a
a
a
a
a
a
a
a
a
a
a
a
a
a
D
a
a
a
a
a
a
a
a
a
a
a
a
a
a
a
a
a
a
a
"}
(6,1,1) = {"
a
a
a
a
a
a
a
a
a
a
a
a
a
a
a
a
a
a
a
D
a
a
a
a
a
a
a
a
a
a
a
a
a
a
a
a
a
a
a
"}
(7,1,1) = {"
a
a
a
a
a
a
a
a
a
a
a
a
a
a
a
a
a
a
a
D
a
a
a
a
a
a
a
a
a
a
a
a
a
a
a
a
a
a
a
"}
(8,1,1) = {"
a
a
a
a
a
a
a
a
a
a
a
a
a
a
a
a
a
a
a
D
a
a
a
a
a
a
a
a
a
a
a
a
a
a
a
a
a
a
a
"}
(9,1,1) = {"
a
a
a
a
a
a
a
a
a
a
a
a
a
a
a
a
a
a
a
D
a
a
a
a
a
a
a
a
a
a
a
a
a
a
a
a
a
a
a
"}
(10,1,1) = {"
a
a
a
a
a
a
a
a
a
a
a
a
a
a
a
a
a
a
a
D
a
a
a
a
a
a
a
a
a
a
a
a
a
a
a
a
a
a
a
"}
(11,1,1) = {"
a
a
a
a
a
a
a
a
a
a
a
a
a
a
a
a
a
a
a
D
a
a
a
a
a
a
a
a
a
a
a
a
a
a
a
a
a
a
a
"}
(12,1,1) = {"
a
a
a
a
a
a
a
a
a
a
a
a
a
a
a
a
a
a
a
D
a
a
a
a
a
a
a
a
a
a
a
a
a
a
a
a
a
a
a
"}
(13,1,1) = {"
a
a
a
a
a
a
a
a
a
a
a
a
a
a
a
a
a
a
a
D
a
a
a
a
a
a
a
a
a
a
a
a
a
a
a
a
a
a
a
"}
(14,1,1) = {"
a
a
a
a
a
a
a
a
a
a
a
a
a
a
a
a
a
a
a
D
a
a
a
a
a
a
a
a
a
a
a
a
a
a
a
a
a
a
a
"}
(15,1,1) = {"
a
a
a
a
a
a
a
a
a
a
a
a
a
a
a
a
a
a
D
D
D
a
a
a
a
a
a
a
a
a
a
a
a
a
a
a
a
a
a
"}
(16,1,1) = {"
a
a
a
a
a
a
a
a
a
a
a
a
a
a
a
D
D
D
D
D
D
D
D
D
a
a
a
a
a
a
a
a
a
a
a
a
a
a
a
"}
(17,1,1) = {"
a
a
a
a
a
a
a
a
a
a
a
a
a
a
a
D
G
B
b
D
k
H
s
D
a
a
a
a
a
a
a
a
a
a
a
a
a
a
a
"}
(18,1,1) = {"
a
a
a
a
a
a
a
a
a
a
a
a
a
a
a
D
u
G
P
D
f
Q
p
D
a
a
a
a
a
a
a
a
a
a
a
a
a
a
a
"}
(19,1,1) = {"
a
a
a
a
a
a
a
a
a
a
a
a
a
a
D
D
F
X
M
D
o
E
J
D
D
a
a
a
a
a
a
a
a
a
a
a
a
a
a
"}
(20,1,1) = {"
D
D
D
D
D
D
D
D
D
D
D
D
D
D
D
D
D
D
D
I
D
D
D
D
D
D
D
D
D
D
D
D
D
D
D
D
D
D
D
"}
(21,1,1) = {"
a
a
a
a
a
a
a
a
a
a
a
a
a
a
D
D
z
U
y
D
l
z
U
D
D
a
a
a
a
a
a
a
a
a
a
a
a
a
a
"}
(22,1,1) = {"
a
a
a
a
a
a
a
a
a
a
a
a
a
a
a
D
e
f
s
D
k
d
p
D
a
a
a
a
a
a
a
a
a
a
a
a
a
a
a
"}
(23,1,1) = {"
a
a
a
a
a
a
a
a
a
a
a
a
a
a
a
D
f
t
d
D
f
t
d
D
a
a
a
a
a
a
a
a
a
a
a
a
a
a
a
"}
(24,1,1) = {"
a
a
a
a
a
a
a
a
a
a
a
a
a
a
a
D
D
D
D
D
D
D
D
D
a
a
a
a
a
a
a
a
a
a
a
a
a
a
a
"}
(25,1,1) = {"
a
a
a
a
a
a
a
a
a
a
a
a
a
a
a
a
a
a
D
D
D
a
a
a
a
a
a
a
a
a
a
a
a
a
a
a
a
a
a
"}
(26,1,1) = {"
a
a
a
a
a
a
a
a
a
a
a
a
a
a
a
a
a
a
a
D
a
a
a
a
a
a
a
a
a
a
a
a
a
a
a
a
a
a
a
"}
(27,1,1) = {"
a
a
a
a
a
a
a
a
a
a
a
a
a
a
a
a
a
a
a
D
a
a
a
a
a
a
a
a
a
a
a
a
a
a
a
a
a
a
a
"}
(28,1,1) = {"
a
a
a
a
a
a
a
a
a
a
a
a
a
a
a
a
a
a
a
D
a
a
a
a
a
a
a
a
a
a
a
a
a
a
a
a
a
a
a
"}
(29,1,1) = {"
a
a
a
a
a
a
a
a
a
a
a
a
a
a
a
a
a
a
a
D
a
a
a
a
a
a
a
a
a
a
a
a
a
a
a
a
a
a
a
"}
(30,1,1) = {"
a
a
a
a
a
a
a
a
a
a
a
a
a
a
a
a
a
a
a
D
a
a
a
a
a
a
a
a
a
a
a
a
a
a
a
a
a
a
a
"}
(31,1,1) = {"
a
a
a
a
a
a
a
a
a
a
a
a
a
a
a
a
a
a
a
D
a
a
a
a
a
a
a
a
a
a
a
a
a
a
a
a
a
a
a
"}
(32,1,1) = {"
a
a
a
a
a
a
a
a
a
a
a
a
a
a
a
a
a
a
a
D
a
a
a
a
a
a
a
a
a
a
a
a
a
a
a
a
a
a
a
"}
(33,1,1) = {"
a
a
a
a
a
a
a
a
a
a
a
a
a
a
a
a
a
a
a
D
a
a
a
a
a
a
a
a
a
a
a
a
a
a
a
a
a
a
a
"}
(34,1,1) = {"
a
a
a
a
a
a
a
a
a
a
a
a
a
a
a
a
a
a
a
D
a
a
a
a
a
a
a
a
a
a
a
a
a
a
a
a
a
a
a
"}
(35,1,1) = {"
a
a
a
a
a
a
a
a
a
a
a
a
a
a
a
a
a
a
a
D
a
a
a
a
a
a
a
a
a
a
a
a
a
a
a
a
a
a
a
"}
(36,1,1) = {"
a
a
a
a
a
a
a
a
a
a
a
a
a
a
a
a
a
a
a
D
a
a
a
a
a
a
a
a
a
a
a
a
a
a
a
a
a
a
a
"}
(37,1,1) = {"
a
a
a
a
a
a
a
a
a
a
a
a
a
a
a
a
a
a
a
D
a
a
a
a
a
a
a
a
a
a
a
a
a
a
a
a
a
a
a
"}
(38,1,1) = {"
a
a
a
a
a
a
a
a
a
a
a
a
a
a
a
a
a
a
a
D
a
a
a
a
a
a
a
a
a
a
a
a
a
a
a
a
a
a
a
"}
(39,1,1) = {"
a
a
a
a
a
a
a
a
a
a
a
a
a
a
a
a
a
a
a
D
a
a
a
a
a
a
a
a
a
a
a
a
a
a
a
a
a
a
a
"}
