//MAP CONVERTED BY dmm2tgm.py THIS HEADER COMMENT PREVENTS RECONVERSION, DO NOT REMOVE
"a" = (
/turf/template_noop,
/area/space)
"c" = (
/obj/item/grown/bananapeel,
/turf/template_noop,
/area/space)
"f" = (
/obj/item/toy/figure/crew/mime{
	pixel_x = -5;
	pixel_y = 17
	},
/turf/template_noop,
/area/space)
"i" = (
/mob/living/simple_animal/hostile/retaliate/clown,
/turf/template_noop,
/area/space)
"j" = (
/mob/living/simple_animal/hostile/retaliate/mime,
/turf/template_noop,
/area/space)
"v" = (
/obj/item/toy/figure/crew/clown{
	pixel_x = -5;
	pixel_y = 17
	},
/turf/template_noop,
/area/space)
"y" = (
/obj/effect/spawner/random/loot/outfit/mime,
/obj/item/clothing/shoes/mime,
/turf/template_noop,
/area/space)
"A" = (
/obj/item/grown/bananapeel/mimanapeel,
/turf/template_noop,
/area/space)
"B" = (
/obj/effect/map_effect/marker/mapmanip/submap/extract/space_ruin/chrono_lab/kitchen_stage,
/turf/template_noop,
/area/space)
"D" = (
/obj/item/clothing/shoes/clown_shoes,
/obj/item/grenade/clown_grenade,
/turf/template_noop,
/area/space)
"E" = (
/obj/item/coin/clown{
	pixel_x = -5;
	pixel_y = -1
	},
/obj/item/toy/crayon/rainbow{
	pixel_x = 8;
	pixel_y = -3
	},
/turf/template_noop,
/area/space)
"M" = (
/obj/item/toy/crayon/mime{
	pixel_x = 4;
	pixel_y = -2
	},
/obj/item/coin/mime{
	pixel_x = -8;
	pixel_y = 4
	},
/turf/template_noop,
/area/space)
"P" = (
/obj/item/flag/mime,
/turf/template_noop,
/area/space)
"S" = (
/obj/item/flag/clown,
/turf/template_noop,
/area/space)
"V" = (
/obj/item/storage/backpack/clown/syndie,
/obj/item/bedsheet/clown,
/turf/template_noop,
/area/space)
"Y" = (
/obj/item/bedsheet/mime,
/obj/item/storage/backpack/mime,
/turf/template_noop,
/area/space)

(1,1,1) = {"
a
a
a
a
a
a
a
a
a
a
a
a
a
a
a
a
a
a
a
a
a
a
a
a
a
a
a
a
a
a
a
a
"}
(2,1,1) = {"
a
a
a
a
B
a
a
a
a
a
a
a
a
a
a
a
a
a
a
a
a
a
a
a
a
a
a
a
a
a
a
a
"}
(3,1,1) = {"
a
a
M
a
a
a
a
a
a
a
a
a
a
a
a
a
a
a
a
a
a
a
a
a
a
a
a
a
a
a
a
a
"}
(4,1,1) = {"
a
a
f
j
a
a
a
a
a
a
a
a
a
a
a
a
a
a
a
a
a
a
a
a
a
a
a
a
a
a
a
a
"}
(5,1,1) = {"
a
a
y
a
a
a
a
a
a
a
a
a
a
a
a
a
a
a
a
a
a
a
a
a
a
a
a
a
a
a
a
a
"}
(6,1,1) = {"
a
a
Y
a
P
a
a
a
a
a
a
a
a
a
a
a
a
a
a
a
a
a
a
a
a
a
a
a
a
a
a
a
"}
(7,1,1) = {"
a
a
a
A
a
a
a
a
a
a
a
a
a
a
a
a
a
a
a
a
a
a
a
a
a
a
a
a
a
a
a
a
"}
(8,1,1) = {"
a
a
a
a
a
a
a
a
a
a
a
a
a
a
a
a
a
a
a
a
a
a
a
a
a
a
a
a
a
a
a
a
"}
(9,1,1) = {"
a
a
a
a
a
a
a
a
a
a
a
a
a
a
a
a
a
a
a
a
a
a
a
a
a
a
a
a
a
a
a
a
"}
(10,1,1) = {"
a
a
a
a
B
a
a
a
a
a
a
a
a
a
a
a
a
a
a
a
a
a
a
a
a
a
a
a
a
a
a
a
"}
(11,1,1) = {"
a
a
E
a
a
a
a
a
a
a
a
a
a
a
a
a
a
a
a
a
a
a
a
a
a
a
a
a
a
a
a
a
"}
(12,1,1) = {"
a
a
v
i
a
a
a
a
a
a
a
a
a
a
a
a
a
a
a
a
a
a
a
a
a
a
a
a
a
a
a
a
"}
(13,1,1) = {"
a
a
D
a
a
a
a
a
a
a
a
a
a
a
a
a
a
a
a
a
a
a
a
a
a
a
a
a
a
a
a
a
"}
(14,1,1) = {"
a
a
V
a
S
a
a
a
a
a
a
a
a
a
a
a
a
a
a
a
a
a
a
a
a
a
a
a
a
a
a
a
"}
(15,1,1) = {"
a
a
a
c
a
a
a
a
a
a
a
a
a
a
a
a
a
a
a
a
a
a
a
a
a
a
a
a
a
a
a
a
"}
(16,1,1) = {"
a
a
a
a
a
a
a
a
a
a
a
a
a
a
a
a
a
a
a
a
a
a
a
a
a
a
a
a
a
a
a
a
"}
(17,1,1) = {"
a
a
a
a
a
a
a
a
a
a
a
a
a
a
a
a
a
a
a
a
a
a
a
a
a
a
a
a
a
a
a
a
"}
(18,1,1) = {"
a
a
a
a
a
a
a
a
a
a
a
a
a
a
a
a
a
a
a
a
a
a
a
a
a
a
a
a
a
a
a
a
"}
(19,1,1) = {"
a
a
a
a
a
a
a
a
a
a
a
a
a
a
a
a
a
a
a
a
a
a
a
a
a
a
a
a
a
a
a
a
"}
(20,1,1) = {"
a
a
a
a
a
a
a
a
a
a
a
a
a
a
a
a
a
a
a
a
a
a
a
a
a
a
a
a
a
a
a
a
"}
(21,1,1) = {"
a
a
a
a
a
a
a
a
a
a
a
a
a
a
a
a
a
a
a
a
a
a
a
a
a
a
a
a
a
a
a
a
"}
(22,1,1) = {"
a
a
a
a
a
a
a
a
a
a
a
a
a
a
a
a
a
a
a
a
a
a
a
a
a
a
a
a
a
a
a
a
"}
(23,1,1) = {"
a
a
a
a
a
a
a
a
a
a
a
a
a
a
a
a
a
a
a
a
a
a
a
a
a
a
a
a
a
a
a
a
"}
(24,1,1) = {"
a
a
a
a
a
a
a
a
a
a
a
a
a
a
a
a
a
a
a
a
a
a
a
a
a
a
a
a
a
a
a
a
"}
(25,1,1) = {"
a
a
a
a
a
a
a
a
a
a
a
a
a
a
a
a
a
a
a
a
a
a
a
a
a
a
a
a
a
a
a
a
"}
(26,1,1) = {"
a
a
a
a
a
a
a
a
a
a
a
a
a
a
a
a
a
a
a
a
a
a
a
a
a
a
a
a
a
a
a
a
"}
(27,1,1) = {"
a
a
a
a
a
a
a
a
a
a
a
a
a
a
a
a
a
a
a
a
a
a
a
a
a
a
a
a
a
a
a
a
"}
(28,1,1) = {"
a
a
a
a
a
a
a
a
a
a
a
a
a
a
a
a
a
a
a
a
a
a
a
a
a
a
a
a
a
a
a
a
"}
(29,1,1) = {"
a
a
a
a
a
a
a
a
a
a
a
a
a
a
a
a
a
a
a
a
a
a
a
a
a
a
a
a
a
a
a
a
"}
(30,1,1) = {"
a
a
a
a
a
a
a
a
a
a
a
a
a
a
a
a
a
a
a
a
a
a
a
a
a
a
a
a
a
a
a
a
"}
(31,1,1) = {"
a
a
a
a
a
a
a
a
a
a
a
a
a
a
a
a
a
a
a
a
a
a
a
a
a
a
a
a
a
a
a
a
"}
(32,1,1) = {"
a
a
a
a
a
a
a
a
a
a
a
a
a
a
a
a
a
a
a
a
a
a
a
a
a
a
a
a
a
a
a
a
"}
