//MAP CONVERTED BY dmm2tgm.py THIS HEADER COMMENT PREVENTS RECONVERSION, DO NOT REMOVE
"aw" = (
/obj/machinery/atmospherics/pipe/simple/heat_exchanging{
	dir = 9
	},
/turf/template_noop,
/area/ruin/space/chrono_lab/telecomms)
"aW" = (
/obj/machinery/atmospherics/pipe/manifold/visible{
	dir = 4
	},
/turf/template_noop,
/area/ruin/space/chrono_lab/telecomms)
"cz" = (
/obj/structure/closet/crate/miningcar,
/obj/effect/spawner/random/loot/good_times,
/turf/simulated/floor/plating/asteroid/basalt,
/area/ruin/space/chrono_lab)
"dR" = (
/mob/living/simple_animal/hostile/retaliate/clown,
/turf/template_noop,
/area/ruin/space/chrono_lab)
"ej" = (
/obj/machinery/light{
	dir = 8
	},
/turf/simulated/floor/plasteel{
	icon_state = "dark"
	},
/area/ruin/space/chrono_lab/telecomms)
"ep" = (
/mob/living/simple_animal/hostile/ash_walker,
/turf/simulated/floor/plating/asteroid/basalt,
/area/ruin/space/chrono_lab)
"fS" = (
/obj/machinery/tcomms/chrono_lab/hub,
/obj/machinery/atmospherics/pipe/simple/heat_exchanging{
	dir = 10
	},
/turf/simulated/floor/bluegrid,
/area/ruin/space/chrono_lab/telecomms)
"fZ" = (
/obj/item/toy/figure/crew/mime{
	pixel_x = -5;
	pixel_y = 17
	},
/turf/template_noop,
/area/ruin/space/chrono_lab)
"hT" = (
/obj/structure/showcase{
	density = 0;
	dir = 8;
	icon = 'icons/mob/robots.dmi';
	icon_state = "robot_old";
	name = "Cyborg Statue";
	pixel_x = 9;
	pixel_y = 2
	},
/turf/simulated/floor/plasteel{
	icon_state = "dark"
	},
/area/ruin/space/chrono_lab/telecomms)
"kd" = (
/obj/item/flag/mime,
/turf/template_noop,
/area/ruin/space/chrono_lab)
"kg" = (
/obj/structure/chair/office/dark{
	dir = 8
	},
/turf/template_noop,
/area/ruin/space/chrono_lab/telecomms)
"kG" = (
/obj/structure/table/wood,
/obj/item/paper/tcommskey{
	pixel_x = -6;
	pixel_y = -2
	},
/obj/item/radio{
	pixel_x = 7;
	pixel_y = 13
	},
/obj/item/pen/edagger{
	pixel_x = -5;
	pixel_y = 6
	},
/obj/effect/map_effect/marker/mapmanip/submap/extract/space_ruin/chrono_lab/telecomms,
/turf/template_noop,
/area/ruin/space/chrono_lab/telecomms)
"kT" = (
/obj/item/grown/bananapeel,
/turf/template_noop,
/area/ruin/space/chrono_lab)
"md" = (
/mob/living/simple_animal/hostile/retaliate/mime,
/turf/template_noop,
/area/ruin/space/chrono_lab)
"mJ" = (
/obj/machinery/blackbox_recorder,
/turf/template_noop,
/area/ruin/space/chrono_lab/telecomms)
"nn" = (
/obj/effect/decal/cleanable/blood,
/turf/simulated/floor/plating/asteroid/basalt,
/area/ruin/space/chrono_lab)
"qa" = (
/obj/effect/map_effect/marker/mapmanip/submap/extract/space_ruin/chrono_lab/front_desk,
/turf/template_noop,
/area/ruin/space/chrono_lab)
"sb" = (
/obj/machinery/light{
	active_power_consumption = 0;
	icon_state = "tube-broken";
	status = 2
	},
/turf/simulated/floor/bluegrid,
/area/ruin/space/chrono_lab/telecomms)
"to" = (
/obj/item/kirbyplants/large,
/turf/template_noop,
/area/ruin/space/chrono_lab/telecomms)
"tF" = (
/obj/item/toy/crayon/mime{
	pixel_x = 4;
	pixel_y = -2
	},
/obj/item/coin/mime{
	pixel_x = -8;
	pixel_y = 4
	},
/turf/template_noop,
/area/ruin/space/chrono_lab)
"tK" = (
/turf/template_noop,
/area/ruin/space/chrono_lab/telecomms)
"tM" = (
/obj/structure/showcase{
	density = 0;
	dir = 8;
	icon = 'icons/mob/robots.dmi';
	icon_state = "robot_old";
	name = "Cyborg Statue";
	pixel_x = 9;
	pixel_y = 2
	},
/turf/template_noop,
/area/ruin/space/chrono_lab/telecomms)
"uO" = (
/obj/machinery/atmospherics/unary/thermomachine/freezer/on/server{
	dir = 1
	},
/turf/template_noop,
/area/ruin/space/chrono_lab/telecomms)
"vm" = (
/obj/item/clothing/shoes/clown_shoes,
/obj/item/grenade/clown_grenade,
/obj/effect/spawner/random/loot/outfit/clown,
/turf/template_noop,
/area/ruin/space/chrono_lab)
"vu" = (
/obj/item/flag/clown,
/turf/template_noop,
/area/ruin/space/chrono_lab)
"vW" = (
/turf/simulated/mineral/random/low_chance/space,
/area/ruin/space/chrono_lab)
"wb" = (
/obj/effect/map_effect/marker/mapmanip/submap/extract/space_ruin/chrono_lab/aft_port,
/turf/simulated/mineral/random/high_chance/space,
/area/ruin/space/chrono_lab)
"xq" = (
/obj/item/toy/figure/crew/clown{
	pixel_x = -5;
	pixel_y = 17
	},
/turf/template_noop,
/area/ruin/space/chrono_lab)
"xL" = (
/obj/machinery/atmospherics/pipe/simple/heat_exchanging,
/turf/template_noop,
/area/ruin/space/chrono_lab/telecomms)
"xM" = (
/obj/machinery/light{
	active_power_consumption = 0;
	icon_state = "tube-broken";
	status = 2
	},
/turf/simulated/floor/plasteel{
	icon_state = "dark"
	},
/area/ruin/space/chrono_lab/telecomms)
"xS" = (
/obj/machinery/tcomms/chrono_lab/processor,
/obj/machinery/atmospherics/pipe/simple/heat_exchanging{
	dir = 9
	},
/turf/simulated/floor/bluegrid,
/area/ruin/space/chrono_lab/telecomms)
"ya" = (
/turf/simulated/floor/lava,
/area/ruin/space/chrono_lab)
"yy" = (
/obj/machinery/atmospherics/pipe/simple/heat_exchanging{
	dir = 5
	},
/turf/template_noop,
/area/ruin/space/chrono_lab/telecomms)
"yU" = (
/obj/machinery/light{
	dir = 1
	},
/turf/simulated/floor/plasteel{
	icon_state = "dark"
	},
/area/ruin/space/chrono_lab/telecomms)
"zz" = (
/obj/machinery/light{
	dir = 1
	},
/turf/simulated/floor/bluegrid,
/area/ruin/space/chrono_lab/telecomms)
"zF" = (
/obj/item/storage/backpack/clown/syndie,
/obj/item/bedsheet/clown,
/turf/template_noop,
/area/ruin/space/chrono_lab)
"zY" = (
/turf/simulated/floor/plating/asteroid/basalt,
/area/ruin/space/chrono_lab)
"Ah" = (
/obj/structure/barricade/wooden/crude,
/turf/template_noop,
/area/ruin/space/chrono_lab)
"CI" = (
/obj/structure/spear_rack,
/obj/item/spear/bonespear,
/obj/item/spear/bonespear,
/turf/simulated/floor/plating/asteroid/basalt,
/area/ruin/space/chrono_lab)
"DO" = (
/obj/structure/rack,
/obj/effect/spawner/random/pool/spaceloot/syndicate/mixed,
/turf/template_noop,
/area/ruin/space/chrono_lab/telecomms)
"Fk" = (
/obj/machinery/atmospherics/pipe/simple/heat_exchanging{
	dir = 6
	},
/turf/template_noop,
/area/ruin/space/chrono_lab/telecomms)
"Fl" = (
/obj/machinery/light{
	dir = 1
	},
/obj/machinery/atmospherics/pipe/simple/heat_exchanging/junction{
	dir = 8
	},
/turf/template_noop,
/area/ruin/space/chrono_lab/telecomms)
"FZ" = (
/obj/effect/spawner/random/loot/outfit/mime,
/obj/item/clothing/shoes/mime,
/turf/template_noop,
/area/ruin/space/chrono_lab)
"Ga" = (
/obj/item/flashlight/lantern{
	on = 1;
	pixel_x = 6;
	pixel_y = 12
	},
/obj/structure/table/wood,
/turf/simulated/floor/plating/asteroid/basalt,
/area/ruin/space/chrono_lab)
"Gh" = (
/obj/machinery/tcomms/relay/chrono_lab,
/turf/simulated/floor/bluegrid,
/area/ruin/space/chrono_lab/telecomms)
"Gk" = (
/obj/item/coin/clown{
	pixel_x = -5;
	pixel_y = -1
	},
/obj/item/toy/crayon/rainbow{
	pixel_x = 8;
	pixel_y = -3
	},
/turf/template_noop,
/area/ruin/space/chrono_lab)
"Gz" = (
/obj/machinery/atmospherics/pipe/simple/visible,
/turf/template_noop,
/area/ruin/space/chrono_lab/telecomms)
"HG" = (
/obj/machinery/atmospherics/unary/tank/oxygen_agent_b,
/turf/template_noop,
/area/ruin/space/chrono_lab/telecomms)
"If" = (
/turf/simulated/floor/plasteel{
	icon_state = "dark"
	},
/area/ruin/space/chrono_lab/telecomms)
"IR" = (
/obj/structure/chair/office/dark{
	dir = 8
	},
/turf/template_noop,
/area/ruin/space/chrono_lab)
"Jc" = (
/obj/machinery/hydroponics/soil,
/obj/item/cultivator/rake,
/turf/simulated/floor/plating/asteroid/basalt,
/area/ruin/space/chrono_lab)
"Jj" = (
/obj/machinery/tcomms/chrono_lab/bus,
/obj/machinery/atmospherics/pipe/simple/heat_exchanging{
	dir = 6
	},
/turf/simulated/floor/bluegrid,
/area/ruin/space/chrono_lab/telecomms)
"Mg" = (
/obj/machinery/porta_turret/syndicate/chrono_lab,
/turf/template_noop,
/area/ruin/space/chrono_lab)
"NA" = (
/obj/machinery/tcomms/chrono_lab/broadcaster,
/obj/machinery/atmospherics/pipe/simple/heat_exchanging{
	dir = 5
	},
/turf/simulated/floor/bluegrid,
/area/ruin/space/chrono_lab/telecomms)
"NF" = (
/obj/machinery/door/airlock/engineering/glass{
	name = "Telecommunication Server Room"
	},
/turf/template_noop,
/area/ruin/space/chrono_lab/telecomms)
"NX" = (
/obj/effect/map_effect/marker/mapmanip/submap/extract/space_ruin/chrono_lab/kitchen_stage,
/turf/template_noop,
/area/ruin/space/chrono_lab)
"Pd" = (
/obj/effect/decal/cleanable/blood,
/obj/effect/mob_spawn/human/corpse/damaged,
/turf/simulated/floor/plating/asteroid/basalt,
/area/ruin/space/chrono_lab)
"Pt" = (
/obj/machinery/tcomms/chrono_lab/server,
/obj/machinery/atmospherics/pipe/simple/heat_exchanging{
	dir = 4
	},
/turf/simulated/floor/bluegrid,
/area/ruin/space/chrono_lab/telecomms)
"PJ" = (
/turf/template_noop,
/area/space)
"PT" = (
/obj/item/bedsheet/mime,
/obj/item/storage/backpack/mime,
/turf/template_noop,
/area/ruin/space/chrono_lab)
"Rx" = (
/obj/machinery/computer/nonfunctional{
	dir = 4
	},
/turf/template_noop,
/area/ruin/space/chrono_lab/telecomms)
"Sk" = (
/obj/machinery/computer/message_monitor{
	dir = 4
	},
/obj/machinery/light{
	dir = 8
	},
/turf/template_noop,
/area/ruin/space/chrono_lab/telecomms)
"Tc" = (
/obj/machinery/light{
	dir = 8
	},
/obj/machinery/computer/nonfunctional{
	dir = 4
	},
/turf/template_noop,
/area/ruin/space/chrono_lab/telecomms)
"UR" = (
/obj/machinery/tcomms/chrono_lab/reciever,
/obj/machinery/atmospherics/pipe/simple/heat_exchanging{
	dir = 6
	},
/turf/simulated/floor/bluegrid,
/area/ruin/space/chrono_lab/telecomms)
"Wt" = (
/obj/structure/table/wood,
/obj/item/paper/tcommskey{
	pixel_x = -6;
	pixel_y = -2
	},
/obj/effect/map_effect/marker/mapmanip/submap/extract/space_ruin/chrono_lab/telecomms,
/obj/item/pen{
	pixel_x = -5;
	pixel_y = 8
	},
/obj/item/radio/headset{
	pixel_x = 7;
	pixel_y = 4
	},
/turf/template_noop,
/area/ruin/space/chrono_lab/telecomms)
"WF" = (
/obj/structure/table/reinforced,
/obj/machinery/computer/med_data/laptop{
	dir = 4
	},
/turf/template_noop,
/area/ruin/space/chrono_lab)
"Xr" = (
/turf/simulated/mineral/random/volcanic,
/area/ruin/space/chrono_lab)
"Yn" = (
/obj/machinery/tcomms/chrono_lab/announcement_system,
/turf/template_noop,
/area/ruin/space/chrono_lab/telecomms)
"YI" = (
/obj/item/grown/bananapeel/mimanapeel,
/turf/template_noop,
/area/ruin/space/chrono_lab)
"Zy" = (
/turf/template_noop,
/area/ruin/space/chrono_lab)
"ZH" = (
/obj/machinery/light{
	active_power_consumption = 0;
	icon_state = "tube-broken";
	status = 2
	},
/obj/machinery/atmospherics/pipe/simple/heat_exchanging/junction{
	dir = 8
	},
/turf/template_noop,
/area/ruin/space/chrono_lab/telecomms)
"ZW" = (
/turf/simulated/wall/indestructible/riveted,
/area/ruin/space/chrono_lab/telecomms)

(1,1,1) = {"
PJ
PJ
PJ
PJ
PJ
PJ
PJ
PJ
PJ
PJ
PJ
PJ
PJ
PJ
PJ
PJ
PJ
PJ
PJ
PJ
PJ
PJ
PJ
PJ
PJ
PJ
PJ
PJ
PJ
PJ
PJ
PJ
"}
(2,1,1) = {"
PJ
PJ
Zy
Zy
NX
PJ
PJ
Zy
Ah
Zy
qa
PJ
PJ
PJ
zY
zY
zY
ya
Xr
wb
PJ
PJ
PJ
PJ
PJ
tK
Rx
Sk
kG
PJ
PJ
PJ
"}
(3,1,1) = {"
PJ
PJ
tF
Zy
Zy
PJ
PJ
Zy
Zy
Zy
Zy
PJ
PJ
PJ
nn
zY
zY
zY
Xr
Xr
PJ
PJ
PJ
PJ
PJ
tK
tK
kg
tK
PJ
PJ
PJ
"}
(4,1,1) = {"
PJ
PJ
fZ
md
Zy
PJ
PJ
Zy
Zy
IR
Zy
PJ
PJ
PJ
Zy
Zy
Zy
nn
ep
vW
PJ
PJ
PJ
PJ
PJ
tK
Yn
tK
tM
PJ
PJ
PJ
"}
(5,1,1) = {"
PJ
PJ
FZ
Zy
Zy
PJ
PJ
Zy
Zy
Zy
Zy
PJ
PJ
PJ
PJ
PJ
Zy
zY
zY
zY
PJ
PJ
PJ
PJ
PJ
tK
tK
NF
tK
PJ
PJ
PJ
"}
(6,1,1) = {"
PJ
PJ
PT
Zy
kd
PJ
PJ
Zy
Zy
Zy
Zy
PJ
PJ
PJ
PJ
PJ
Zy
CI
zY
cz
PJ
PJ
PJ
tK
tK
tK
UR
xL
NA
PJ
PJ
PJ
"}
(7,1,1) = {"
PJ
PJ
Zy
YI
Zy
PJ
PJ
PJ
PJ
PJ
PJ
PJ
PJ
PJ
Zy
Zy
Zy
nn
zY
zY
PJ
PJ
PJ
tK
Jj
xL
aw
tK
Pt
PJ
PJ
PJ
"}
(8,1,1) = {"
PJ
PJ
PJ
PJ
PJ
PJ
PJ
Zy
Zy
Zy
qa
PJ
PJ
PJ
Zy
Zy
Zy
zY
zY
Jc
PJ
PJ
PJ
tK
fS
yy
tK
Fk
xS
PJ
PJ
PJ
"}
(9,1,1) = {"
PJ
PJ
PJ
PJ
PJ
PJ
PJ
Zy
Zy
WF
Zy
PJ
PJ
PJ
Zy
Zy
Zy
Ga
zY
Pd
PJ
PJ
PJ
tK
tK
Fl
tK
ZH
ZW
PJ
PJ
PJ
"}
(10,1,1) = {"
PJ
PJ
Zy
Zy
NX
PJ
PJ
Zy
Zy
Mg
Zy
PJ
PJ
PJ
Zy
Zy
Zy
zY
zY
zY
PJ
PJ
PJ
tK
HG
aW
Gz
aW
uO
PJ
PJ
PJ
"}
(11,1,1) = {"
PJ
PJ
Gk
Zy
Zy
PJ
PJ
Zy
Zy
Zy
Zy
PJ
PJ
PJ
PJ
PJ
PJ
PJ
PJ
PJ
PJ
PJ
PJ
PJ
PJ
PJ
PJ
PJ
PJ
PJ
PJ
PJ
"}
(12,1,1) = {"
PJ
PJ
xq
dR
Zy
PJ
PJ
Zy
Zy
Zy
Zy
PJ
PJ
PJ
PJ
PJ
PJ
PJ
PJ
PJ
PJ
PJ
PJ
PJ
PJ
ZW
Rx
Tc
Wt
PJ
PJ
PJ
"}
(13,1,1) = {"
PJ
PJ
vm
Zy
Zy
PJ
PJ
PJ
PJ
PJ
PJ
PJ
PJ
PJ
PJ
PJ
PJ
PJ
PJ
PJ
PJ
PJ
PJ
PJ
PJ
ZW
tK
kg
tK
PJ
PJ
PJ
"}
(14,1,1) = {"
PJ
PJ
zF
Zy
vu
PJ
PJ
PJ
PJ
PJ
PJ
PJ
PJ
PJ
PJ
PJ
PJ
PJ
PJ
PJ
PJ
PJ
PJ
PJ
PJ
ZW
DO
tK
tM
PJ
PJ
PJ
"}
(15,1,1) = {"
PJ
PJ
Zy
kT
Zy
PJ
PJ
PJ
PJ
PJ
PJ
PJ
PJ
PJ
PJ
PJ
PJ
PJ
PJ
PJ
PJ
PJ
PJ
PJ
PJ
ZW
ZW
NF
ZW
PJ
PJ
PJ
"}
(16,1,1) = {"
PJ
PJ
PJ
PJ
PJ
PJ
PJ
PJ
PJ
PJ
PJ
PJ
PJ
PJ
PJ
PJ
PJ
PJ
PJ
PJ
PJ
PJ
PJ
ZW
ZW
ZW
to
tK
to
PJ
PJ
PJ
"}
(17,1,1) = {"
PJ
PJ
PJ
PJ
PJ
PJ
PJ
PJ
PJ
PJ
PJ
PJ
PJ
PJ
PJ
PJ
PJ
PJ
PJ
PJ
PJ
PJ
PJ
ZW
mJ
tK
tK
tK
tK
PJ
PJ
PJ
"}
(18,1,1) = {"
PJ
PJ
PJ
PJ
PJ
PJ
PJ
PJ
PJ
PJ
PJ
PJ
PJ
PJ
PJ
PJ
PJ
PJ
PJ
PJ
PJ
PJ
PJ
ZW
mJ
tK
tK
tK
tK
PJ
PJ
PJ
"}
(19,1,1) = {"
PJ
PJ
PJ
PJ
PJ
PJ
PJ
PJ
PJ
PJ
PJ
PJ
PJ
PJ
PJ
PJ
PJ
PJ
PJ
PJ
PJ
PJ
PJ
ZW
ZW
zz
tK
sb
ZW
PJ
PJ
PJ
"}
(20,1,1) = {"
PJ
PJ
PJ
PJ
PJ
PJ
PJ
PJ
PJ
PJ
PJ
PJ
PJ
PJ
PJ
PJ
PJ
PJ
PJ
PJ
PJ
PJ
PJ
ZW
tK
tK
Gh
tK
tK
PJ
PJ
PJ
"}
(21,1,1) = {"
PJ
PJ
PJ
PJ
PJ
PJ
PJ
PJ
PJ
PJ
PJ
PJ
PJ
PJ
PJ
PJ
PJ
PJ
PJ
PJ
PJ
PJ
PJ
PJ
PJ
PJ
PJ
PJ
PJ
PJ
PJ
PJ
"}
(22,1,1) = {"
PJ
PJ
PJ
PJ
PJ
PJ
PJ
PJ
PJ
PJ
PJ
PJ
PJ
PJ
PJ
PJ
PJ
PJ
PJ
PJ
PJ
PJ
PJ
PJ
PJ
ZW
If
ej
If
PJ
PJ
PJ
"}
(23,1,1) = {"
PJ
PJ
PJ
PJ
PJ
PJ
PJ
PJ
PJ
PJ
PJ
PJ
PJ
PJ
PJ
PJ
PJ
PJ
PJ
PJ
PJ
PJ
PJ
PJ
PJ
ZW
If
If
If
PJ
PJ
PJ
"}
(24,1,1) = {"
PJ
PJ
PJ
PJ
PJ
PJ
PJ
PJ
PJ
PJ
PJ
PJ
PJ
PJ
PJ
PJ
PJ
PJ
PJ
PJ
PJ
PJ
PJ
PJ
PJ
ZW
If
If
hT
PJ
PJ
PJ
"}
(25,1,1) = {"
PJ
PJ
PJ
PJ
PJ
PJ
PJ
PJ
PJ
PJ
PJ
PJ
PJ
PJ
PJ
PJ
PJ
PJ
PJ
PJ
PJ
PJ
PJ
PJ
PJ
ZW
ZW
If
ZW
PJ
PJ
PJ
"}
(26,1,1) = {"
PJ
PJ
PJ
PJ
PJ
PJ
PJ
PJ
PJ
PJ
PJ
PJ
PJ
PJ
PJ
PJ
PJ
PJ
PJ
PJ
PJ
PJ
PJ
ZW
ZW
ZW
If
If
If
PJ
PJ
PJ
"}
(27,1,1) = {"
PJ
PJ
PJ
PJ
PJ
PJ
PJ
PJ
PJ
PJ
PJ
PJ
PJ
PJ
PJ
PJ
PJ
PJ
PJ
PJ
PJ
PJ
PJ
ZW
If
If
If
If
If
PJ
PJ
PJ
"}
(28,1,1) = {"
PJ
PJ
PJ
PJ
PJ
PJ
PJ
PJ
PJ
PJ
PJ
PJ
PJ
PJ
PJ
PJ
PJ
PJ
PJ
PJ
PJ
PJ
PJ
ZW
If
If
If
If
If
PJ
PJ
PJ
"}
(29,1,1) = {"
PJ
PJ
PJ
PJ
PJ
PJ
PJ
PJ
PJ
PJ
PJ
PJ
PJ
PJ
PJ
PJ
PJ
PJ
PJ
PJ
PJ
PJ
PJ
ZW
ZW
yU
If
xM
ZW
PJ
PJ
PJ
"}
(30,1,1) = {"
PJ
PJ
PJ
PJ
PJ
PJ
PJ
PJ
PJ
PJ
PJ
PJ
PJ
PJ
PJ
PJ
PJ
PJ
PJ
PJ
PJ
PJ
PJ
ZW
If
If
If
If
If
PJ
PJ
PJ
"}
(31,1,1) = {"
PJ
PJ
PJ
PJ
PJ
PJ
PJ
PJ
PJ
PJ
PJ
PJ
PJ
PJ
PJ
PJ
PJ
PJ
PJ
PJ
PJ
PJ
PJ
PJ
PJ
PJ
PJ
PJ
PJ
PJ
PJ
PJ
"}
(32,1,1) = {"
PJ
PJ
PJ
PJ
PJ
PJ
PJ
PJ
PJ
PJ
PJ
PJ
PJ
PJ
PJ
PJ
PJ
PJ
PJ
PJ
PJ
PJ
PJ
PJ
PJ
PJ
PJ
PJ
PJ
PJ
PJ
PJ
"}
