//MAP CONVERTED BY dmm2tgm.py THIS HEADER COMMENT PREVENTS RECONVERSION, DO NOT REMOVE
"a" = (
/obj/structure/window/plastitanium,
/turf/simulated/floor/plating/asteroid/basalt,
/area/lavaland/surface/outdoors/unexplored)
"f" = (
/obj/structure/marker_beacon,
/turf/simulated/floor/plating/asteroid/basalt,
/area/lavaland/surface/outdoors/unexplored)
"i" = (
/obj/structure/window/plastitanium,
/obj/structure/window/plastitanium{
	dir = 8
	},
/turf/simulated/floor/plating/asteroid/basalt,
/area/lavaland/surface/outdoors/unexplored)
"k" = (
/turf/simulated/floor/lava/lava_land_surface,
/area/lavaland/surface/outdoors/unexplored)
"o" = (
/obj/structure/flora/ash/tall_shroom,
/turf/simulated/floor/plating/asteroid/basalt,
/area/lavaland/surface/outdoors/unexplored)
"q" = (
/turf/template_noop,
/area/template_noop)
"x" = (
/obj/structure/diorama_sign,
/turf/template_noop,
/area/template_noop)
"B" = (
/obj/structure/window/plastitanium{
	dir = 4
	},
/turf/simulated/floor/plating/asteroid/basalt,
/area/lavaland/surface/outdoors/unexplored)
"C" = (
/obj/structure/window/plastitanium{
	dir = 1
	},
/turf/simulated/floor/plating/asteroid/basalt,
/area/lavaland/surface/outdoors/unexplored)
"G" = (
/obj/item/kinetic_crusher,
/turf/simulated/floor/plating/asteroid/basalt,
/area/lavaland/surface/outdoors/unexplored)
"H" = (
/obj/structure/window/plastitanium{
	dir = 4
	},
/obj/structure/window/plastitanium{
	dir = 1
	},
/turf/simulated/floor/plating/asteroid/basalt,
/area/lavaland/surface/outdoors/unexplored)
"L" = (
/obj/structure/window/plastitanium{
	dir = 8
	},
/turf/simulated/floor/plating/asteroid/basalt,
/area/lavaland/surface/outdoors/unexplored)
"M" = (
/obj/structure/flora/ash/rock,
/turf/simulated/floor/plating/asteroid/basalt,
/area/lavaland/surface/outdoors/unexplored)
"R" = (
/obj/structure/window/plastitanium{
	dir = 8
	},
/obj/structure/window/plastitanium{
	dir = 1
	},
/turf/simulated/floor/plating/asteroid/basalt,
/area/lavaland/surface/outdoors/unexplored)
"S" = (
/obj/structure/flora/ash/rock,
/obj/structure/window/plastitanium,
/turf/simulated/floor/plating/asteroid/basalt,
/area/lavaland/surface/outdoors/unexplored)
"X" = (
/obj/structure/window/plastitanium,
/obj/structure/window/plastitanium{
	dir = 4
	},
/turf/simulated/floor/plating/asteroid/basalt,
/area/lavaland/surface/outdoors/unexplored)

(1,1,1) = {"
R
L
L
L
L
i
q
"}
(2,1,1) = {"
C
k
k
k
G
S
q
"}
(3,1,1) = {"
C
k
o
k
o
a
x
"}
(4,1,1) = {"
C
f
M
k
k
a
q
"}
(5,1,1) = {"
H
B
B
B
B
X
q
"}
