//MAP CONVERTED BY dmm2tgm.py THIS HEADER COMMENT PREVENTS RECONVERSION, DO NOT REMOVE
"aB" = (
/obj/effect/landmark{
	icon = 'icons/effects/spawner_icons.dmi';
	icon_state = "spooky";
	name = "Observer-Start"
	},
/turf/open/floor/plating,
/area/space)
"aX" = (
/obj/machinery/light{
	active_power_consumption = 0;
	icon_state = "tube-broken";
	status = 2;
	dir = 4
	},
/turf/simulated/floor/engine/airless,
/area/ruin/space/chrono_lab)
"aZ" = (
/turf/simulated/floor/engine/airless,
/area/space)
"bE" = (
/obj/structure/marker_beacon/dock_marker,
/obj/effect/turf_decal/stripes/line{
	dir = 5
	},
/turf/open/floor/plating,
/area/space)
"bH" = (
/turf/simulated/floor/engine/airless,
/area/ruin/space/chrono_lab/mazegen)
"bL" = (
/obj/structure/railing/corner{
	dir = 1
	},
/obj/effect/turf_decal/stripes/corner{
	dir = 1
	},
/obj/structure/fans/tiny,
/turf/simulated/floor/engine/airless,
/area/space)
"cH" = (
/turf/simulated/floor/plating/asteroid/ancient,
/area/space)
"cN" = (
/obj/item/shovel,
/turf/simulated/floor/plating/asteroid/ancient,
/area/space)
"eq" = (
/obj/machinery/light{
	active_power_consumption = 0;
	icon_state = "tube-broken";
	status = 2;
	dir = 8
	},
/obj/item/radio/intercom{
	name = "north bump";
	pixel_y = 28
	},
/turf/simulated/floor/engine/airless,
/area/ruin/space/chrono_lab)
"fw" = (
/obj/structure/railing{
	dir = 4
	},
/obj/effect/turf_decal/stripes/line{
	dir = 4
	},
/turf/simulated/floor/engine/airless,
/area/space)
"gF" = (
/obj/effect/landmark/start/chief_engineer,
/turf/simulated/floor/engine/airless,
/area/space)
"hp" = (
/obj/structure/railing/corner,
/obj/effect/turf_decal/stripes/corner,
/turf/simulated/floor/engine/airless,
/area/space)
"jl" = (
/obj/structure/rack{
	dir = 1
	},
/obj/item/tank/internals/emergency_oxygen{
	pixel_x = -8;
	pixel_y = 7
	},
/obj/item/tank/internals/emergency_oxygen{
	pixel_x = 9;
	pixel_y = -5
	},
/obj/item/tank/internals/emergency_oxygen,
/turf/simulated/floor/plating/asteroid/ancient,
/area/space)
"jB" = (
/obj/effect/turf_decal/stripes/line,
/turf/open/floor/plating,
/area/space)
"ky" = (
/turf/simulated/floor/transparent/glass/reinforced,
/area/ruin/space/chrono_lab)
"lJ" = (
/turf/simulated/wall/indestructible/riveted,
/area/space)
"lX" = (
/obj/structure/railing/corner{
	dir = 8
	},
/obj/effect/turf_decal/stripes/corner{
	dir = 8
	},
/turf/simulated/floor/engine/airless,
/area/space)
"mo" = (
/obj/effect/map_effect/marker/mapmanip/submap/insert/space_ruin/chrono_lab/front_desk,
/turf/simulated/wall/indestructible/riveted,
/area/ruin/space/chrono_lab)
"oQ" = (
/obj/item/kirbyplants/large,
/obj/structure/extinguisher_cabinet{
	name = "south bump";
	pixel_y = -30
	},
/turf/simulated/floor/engine/airless,
/area/ruin/space/chrono_lab)
"qn" = (
/obj/structure/sign/securearea{
	name = "\improper STAY CLEAR: ANOMALOUS BLUESPACE MATTER";
	desc = "A warning sign which reads 'STAY CLEAR'."
	},
/turf/simulated/wall/indestructible/riveted,
/area/space)
"ss" = (
/obj/effect/spawner/random/plushies,
/turf/simulated/floor/plating/asteroid/ancient,
/area/space)
"sI" = (
/turf/simulated/floor/plasteel{
	icon_state = "stairs"
	},
/area/space)
"sV" = (
/turf/simulated/floor/bluespace_river,
/area/space)
"tX" = (
/obj/structure/railing/corner{
	dir = 4
	},
/obj/effect/turf_decal/stripes/corner{
	dir = 4
	},
/obj/structure/fans/tiny,
/turf/simulated/floor/engine/airless,
/area/space)
"uy" = (
/obj/structure/railing{
	dir = 8
	},
/obj/effect/turf_decal/stripes/line{
	dir = 8
	},
/turf/simulated/floor/engine/airless,
/area/space)
"vc" = (
/obj/structure/fans/tiny,
/turf/simulated/floor/engine/airless,
/area/space)
"vC" = (
/obj/effect/decal/remains/human,
/turf/simulated/floor/plating/asteroid/ancient,
/area/space)
"xp" = (
/obj/effect/turf_decal/stripes/line{
	dir = 8
	},
/turf/open/floor/plating,
/area/space)
"yq" = (
/turf/simulated/mineral,
/area/space)
"yK" = (
/obj/item/chair/light{
	dir = 4
	},
/turf/simulated/floor/plating/asteroid/ancient,
/area/space)
"Ai" = (
/turf/simulated/floor/engine/airless,
/area/ruin/space/chrono_lab)
"Cj" = (
/obj/structure/table,
/obj/item/stack/ore/bluespace_crystal/refined,
/turf/simulated/floor/plating/asteroid/ancient,
/area/space)
"Ck" = (
/obj/effect/step_trigger/blindness,
/turf/simulated/floor/engine/airless,
/area/ruin/space/chrono_lab)
"Fv" = (
/obj/structure/marker_beacon/dock_marker,
/obj/effect/turf_decal/stripes/line{
	dir = 1
	},
/turf/open/floor/plating,
/area/space)
"Fy" = (
/obj/structure/marker_beacon/dock_marker,
/obj/effect/turf_decal/stripes/line{
	dir = 6
	},
/turf/open/floor/plating,
/area/space)
"FL" = (
/obj/effect/decal/cleanable/cobweb2,
/turf/simulated/floor/engine/airless,
/area/ruin/space/chrono_lab/mazegen)
"FR" = (
/obj/item/pickaxe,
/turf/simulated/floor/plating/asteroid/ancient,
/area/space)
"FS" = (
/obj/structure/railing{
	dir = 4
	},
/obj/effect/turf_decal/stripes/line{
	dir = 4
	},
/obj/effect/turf_decal/stripes/line{
	dir = 4
	},
/turf/simulated/floor/engine/airless,
/area/space)
"GG" = (
/obj/structure/marker_beacon/dock_marker,
/obj/effect/turf_decal/stripes/line{
	dir = 9
	},
/turf/open/floor/plating,
/area/space)
"HK" = (
/obj/effect/mapping_helpers/airlock/locked,
/obj/machinery/door/airlock/vault,
/turf/simulated/floor/engine/airless,
/area/space)
"Ki" = (
/turf/open/floor/plating,
/area/space)
"KG" = (
/obj/machinery/recharger/wallcharger{
	pixel_y = 25
	},
/obj/machinery/recharger/wallcharger{
	pixel_y = 35
	},
/turf/simulated/floor/engine/airless,
/area/ruin/space/chrono_lab/mazegen)
"NY" = (
/obj/machinery/door/airlock/vault,
/turf/simulated/floor/engine/airless,
/area/space)
"Ps" = (
/obj/structure/filingcabinet,
/turf/simulated/floor/engine/airless,
/area/ruin/space/chrono_lab/mazegen)
"Qh" = (
/obj/effect/spawner/window/plastitanium,
/turf/simulated/floor/engine/airless,
/area/ruin/space/chrono_lab)
"QO" = (
/turf/simulated/wall/indestructible/riveted,
/area/ruin/space/chrono_lab/mazegen)
"Rj" = (
/turf/simulated/wall/indestructible/riveted,
/area/ruin/space/chrono_lab)
"Tl" = (
/obj/effect/turf_decal/stripes/line{
	dir = 1
	},
/turf/open/floor/plating,
/area/space)
"Tq" = (
/obj/item/stack/ore/glass,
/turf/simulated/floor/plating/asteroid/ancient,
/area/space)
"TK" = (
/turf/space,
/area/space)
"Uv" = (
/obj/structure/railing{
	dir = 8
	},
/obj/structure/railing{
	dir = 8
	},
/obj/effect/turf_decal/stripes/line{
	dir = 8
	},
/turf/simulated/floor/engine/airless,
/area/space)
"UW" = (
/turf/simulated/mineral/random/low_chance/space,
/area/space)
"Vd" = (
/obj/structure/marker_beacon/dock_marker,
/obj/effect/turf_decal/stripes/line,
/turf/open/floor/plating,
/area/space)
"Vm" = (
/obj/structure/marker_beacon/dock_marker,
/obj/effect/turf_decal/stripes/line{
	dir = 10
	},
/turf/open/floor/plating,
/area/space)
"Wb" = (
/obj/item/kirbyplants/large,
/turf/simulated/floor/engine/airless,
/area/ruin/space/chrono_lab)
"XM" = (
/obj/effect/turf_decal/stripes/line{
	dir = 4
	},
/turf/open/floor/plating,
/area/space)
"Ya" = (
/obj/machinery/door/airlock/highsecurity,
/turf/simulated/floor/engine/airless,
/area/ruin/space/chrono_lab)
"Yo" = (
/obj/structure/table/reinforced,
/obj/machinery/door/window/reinforced/normal{
	dir = 1
	},
/turf/simulated/floor/engine/airless,
/area/ruin/space/chrono_lab)
"YM" = (
/turf/simulated/mineral/random/high_chance/space,
/area/space)
"Zy" = (
/obj/structure/marker_beacon/dock_marker,
/obj/effect/turf_decal/stripes/line,
/obj/effect/turf_decal/stripes/line,
/turf/open/floor/plating,
/area/space)

(1,1,1) = {"
TK
TK
TK
TK
TK
TK
TK
TK
TK
TK
TK
TK
TK
TK
TK
TK
TK
TK
TK
TK
TK
TK
TK
TK
TK
TK
TK
TK
TK
TK
TK
TK
TK
TK
TK
TK
TK
TK
TK
TK
TK
TK
TK
TK
yq
yq
yq
TK
TK
TK
cH
cH
cH
cH
cH
cH
cH
cH
cH
cH
cH
cH
cH
cH
cH
cH
cH
cH
cH
cH
cH
cH
cH
cH
cH
"}
(2,1,1) = {"
TK
TK
TK
TK
TK
TK
TK
TK
TK
TK
TK
TK
TK
TK
TK
TK
TK
TK
TK
TK
TK
TK
TK
TK
TK
TK
TK
TK
TK
TK
TK
TK
TK
TK
TK
TK
TK
TK
TK
TK
TK
TK
TK
TK
TK
TK
yq
yq
cH
cH
cH
cH
cH
cH
cH
cH
cH
cH
cH
cH
cH
cH
cH
cH
cH
cH
cH
cH
cH
cH
cH
cH
cH
cH
cH
"}
(3,1,1) = {"
TK
TK
TK
TK
TK
TK
TK
TK
TK
TK
TK
TK
TK
TK
TK
TK
TK
TK
TK
TK
TK
TK
TK
TK
TK
TK
TK
TK
TK
TK
TK
TK
TK
TK
TK
TK
TK
TK
TK
TK
TK
TK
TK
TK
TK
TK
TK
yq
cH
cH
cH
cH
Tq
yq
yq
cH
cH
cH
cH
GG
xp
xp
xp
xp
xp
xp
xp
xp
xp
xp
xp
xp
Vm
cH
cH
"}
(4,1,1) = {"
TK
TK
TK
TK
TK
TK
TK
TK
TK
TK
TK
TK
TK
TK
TK
TK
TK
TK
TK
TK
TK
TK
TK
TK
TK
TK
TK
TK
TK
TK
TK
TK
TK
TK
TK
TK
TK
TK
TK
TK
TK
TK
TK
TK
TK
TK
TK
yq
cH
cH
cH
UW
cH
YM
UW
UW
cH
cH
cH
Tl
Ki
Ki
Ki
Ki
Ki
Ki
Ki
Ki
Ki
Ki
Ki
Ki
jB
cH
cH
"}
(5,1,1) = {"
TK
TK
TK
TK
TK
TK
TK
TK
TK
TK
TK
TK
TK
TK
TK
TK
TK
TK
TK
TK
TK
TK
TK
TK
TK
TK
TK
TK
TK
TK
TK
TK
TK
TK
TK
TK
TK
TK
TK
TK
TK
TK
TK
TK
TK
TK
TK
yq
cH
cH
yq
ss
YM
YM
Tq
cH
yK
cH
cH
Tl
Ki
Ki
Ki
Ki
Ki
Ki
Ki
Ki
Ki
Ki
Ki
Ki
jB
cH
cH
"}
(6,1,1) = {"
TK
TK
TK
TK
TK
TK
TK
TK
TK
TK
TK
TK
TK
TK
TK
TK
TK
TK
TK
TK
TK
TK
TK
TK
TK
TK
TK
TK
TK
TK
TK
TK
TK
TK
TK
TK
TK
TK
TK
TK
TK
TK
TK
TK
TK
TK
yq
yq
cH
cH
Tq
yq
YM
cH
UW
Cj
cH
cH
cH
Tl
Ki
Ki
Ki
Ki
Ki
Ki
Ki
Ki
Ki
Ki
Ki
Ki
jB
cH
cH
"}
(7,1,1) = {"
TK
TK
TK
TK
TK
TK
TK
TK
TK
TK
TK
TK
TK
TK
TK
TK
TK
TK
TK
TK
TK
TK
TK
TK
TK
TK
TK
TK
TK
TK
TK
TK
TK
TK
TK
TK
TK
TK
TK
TK
TK
TK
TK
TK
TK
TK
yq
TK
cH
cH
cH
YM
jl
FR
cH
cH
Tq
cH
cH
Tl
Ki
Ki
Ki
Ki
Ki
Ki
Ki
Ki
Ki
Ki
Ki
Ki
jB
cH
cH
"}
(8,1,1) = {"
TK
TK
TK
TK
TK
TK
TK
TK
TK
TK
TK
TK
TK
TK
TK
TK
TK
TK
TK
TK
TK
TK
TK
TK
TK
TK
TK
TK
TK
TK
TK
TK
TK
TK
TK
TK
TK
TK
TK
TK
TK
TK
TK
TK
TK
yq
yq
TK
cH
cH
cH
cH
cH
cH
cH
cH
cH
cH
cH
Fv
Ki
Ki
Ki
Ki
Ki
Ki
Ki
Ki
Ki
Ki
Ki
Ki
Vd
cH
cH
"}
(9,1,1) = {"
TK
TK
TK
TK
TK
TK
QO
QO
QO
QO
QO
QO
QO
QO
QO
QO
QO
QO
QO
QO
QO
QO
QO
QO
QO
QO
QO
QO
QO
QO
QO
QO
QO
QO
QO
QO
QO
QO
QO
QO
QO
QO
TK
TK
yq
TK
TK
TK
cH
cH
cH
cH
cH
cH
Tq
cH
cH
cH
cH
Tl
Ki
Ki
Ki
Ki
Ki
Ki
Ki
Ki
Ki
Ki
Ki
Ki
jB
cH
cH
"}
(10,1,1) = {"
TK
TK
TK
TK
TK
TK
QO
QO
QO
QO
QO
QO
QO
QO
QO
QO
QO
QO
QO
QO
QO
QO
QO
QO
QO
QO
QO
QO
QO
QO
QO
QO
QO
QO
QO
QO
QO
QO
QO
QO
QO
QO
TK
TK
yq
TK
TK
TK
cH
cH
cH
cH
cH
cH
cH
cH
cH
cH
cH
Tl
Ki
Ki
Ki
Ki
Ki
Ki
Ki
Ki
Ki
Ki
Ki
Ki
jB
cH
cH
"}
(11,1,1) = {"
TK
TK
TK
TK
TK
TK
QO
QO
QO
QO
QO
QO
QO
QO
QO
QO
QO
QO
QO
QO
QO
QO
QO
QO
QO
QO
QO
QO
QO
QO
QO
QO
QO
QO
QO
QO
QO
QO
QO
QO
QO
QO
TK
yq
yq
lJ
lJ
lJ
lJ
lJ
lJ
lJ
cH
cH
cH
cH
Tq
cH
cH
Tl
Ki
Ki
Ki
Ki
Ki
Ki
Ki
Ki
Ki
Ki
Ki
Ki
jB
cH
cH
"}
(12,1,1) = {"
TK
TK
TK
TK
TK
TK
QO
QO
QO
QO
QO
QO
QO
QO
QO
QO
QO
QO
QO
QO
QO
QO
QO
QO
QO
QO
QO
QO
QO
QO
QO
QO
QO
QO
QO
QO
QO
Rj
Rj
Ya
Rj
Rj
yq
yq
lJ
lJ
sV
sV
sV
sV
sV
lJ
lJ
cH
cH
cH
cH
cH
cH
Tl
Ki
Ki
Ki
Ki
aB
Ki
Ki
Ki
Ki
Ki
Ki
Ki
jB
cH
cH
"}
(13,1,1) = {"
TK
TK
TK
TK
TK
TK
QO
QO
QO
QO
QO
QO
QO
QO
QO
QO
QO
QO
QO
QO
QO
QO
QO
QO
QO
QO
QO
QO
QO
QO
QO
QO
QO
QO
QO
QO
QO
Rj
eq
ky
oQ
Rj
yq
lJ
lJ
sV
sV
sV
sV
sV
sV
sV
lJ
lJ
cH
cH
cH
cH
cH
Fv
Ki
Ki
Ki
Ki
Ki
Ki
Ki
Ki
Ki
Ki
Ki
Ki
Zy
cH
cH
"}
(14,1,1) = {"
TK
TK
TK
TK
TK
TK
QO
QO
QO
QO
QO
QO
QO
QO
QO
QO
QO
QO
QO
QO
QO
QO
QO
QO
QO
QO
QO
QO
QO
QO
QO
QO
QO
QO
Rj
Ya
Rj
mo
Ai
ky
Ai
Rj
lJ
lJ
sV
sV
sV
sV
sV
sV
sV
sV
sV
lJ
lJ
cH
cH
cH
cH
Tl
Ki
Ki
Ki
Ki
Ki
Ki
Ki
Ki
Ki
Ki
Ki
Ki
jB
cH
cH
"}
(15,1,1) = {"
TK
TK
TK
TK
TK
TK
QO
QO
QO
QO
QO
QO
QO
QO
QO
QO
QO
QO
QO
QO
QO
QO
QO
QO
QO
QO
QO
QO
QO
QO
QO
QO
QO
QO
Rj
bH
bH
Qh
ky
ky
Ai
Ck
NY
lX
uy
uy
uy
uy
uy
uy
Uv
uy
uy
bL
sI
sI
cH
cH
cH
Tl
Ki
Ki
Ki
Ki
Ki
Ki
Ki
Ki
Ki
Ki
Ki
Ki
jB
cH
cH
"}
(16,1,1) = {"
TK
TK
TK
TK
TK
TK
QO
QO
QO
QO
QO
QO
QO
QO
QO
QO
QO
QO
QO
QO
QO
QO
QO
QO
QO
QO
QO
QO
QO
QO
QO
QO
QO
QO
Rj
KG
bH
Yo
ky
ky
ky
ky
lJ
aZ
aZ
aZ
aZ
aZ
aZ
aZ
aZ
gF
aZ
vc
sI
sI
cH
cH
cH
Tl
Ki
Ki
Ki
Ki
Ki
Ki
Ki
Ki
Ki
Ki
Ki
Ki
jB
cH
cH
"}
(17,1,1) = {"
TK
TK
TK
TK
TK
TK
QO
QO
QO
QO
QO
QO
QO
QO
QO
QO
QO
QO
QO
QO
QO
QO
QO
QO
QO
QO
QO
QO
QO
QO
QO
QO
QO
QO
Rj
FL
Ps
Qh
ky
ky
Ai
Ai
HK
hp
fw
fw
fw
fw
fw
FS
fw
fw
fw
tX
sI
sI
cH
cH
cH
Tl
Ki
Ki
Ki
Ki
Ki
Ki
Ki
Ki
Ki
Ki
Ki
Ki
jB
cH
cH
"}
(18,1,1) = {"
TK
TK
TK
TK
TK
TK
QO
QO
QO
QO
QO
QO
QO
QO
QO
QO
QO
QO
QO
QO
QO
QO
QO
QO
QO
QO
QO
QO
QO
QO
QO
QO
QO
QO
Rj
Rj
Rj
Rj
Ai
ky
Ai
Rj
lJ
lJ
sV
sV
sV
sV
sV
sV
sV
sV
sV
lJ
lJ
cH
cH
cH
cH
Fv
Ki
Ki
Ki
Ki
Ki
Ki
Ki
Ki
Ki
Ki
Ki
Ki
Vd
cH
cH
"}
(19,1,1) = {"
TK
TK
TK
TK
TK
TK
QO
QO
QO
QO
QO
QO
QO
QO
QO
QO
QO
QO
QO
QO
QO
QO
QO
QO
QO
QO
QO
QO
QO
QO
QO
QO
QO
QO
QO
QO
QO
Rj
aX
ky
Wb
Rj
TK
lJ
lJ
sV
sV
sV
sV
sV
sV
sV
lJ
lJ
cH
cH
cH
cH
cH
Tl
Ki
Ki
Ki
Ki
Ki
Ki
Ki
Ki
Ki
Ki
Ki
Ki
jB
cH
cH
"}
(20,1,1) = {"
TK
TK
TK
TK
TK
TK
QO
QO
QO
QO
QO
QO
QO
QO
QO
QO
QO
QO
QO
QO
QO
QO
QO
QO
QO
QO
QO
QO
QO
QO
QO
QO
QO
QO
QO
QO
QO
Rj
Rj
Ya
Rj
QO
TK
TK
lJ
lJ
sV
sV
sV
sV
sV
lJ
lJ
cH
cH
cH
cH
cH
cH
Tl
Ki
Ki
Ki
Ki
Ki
Ki
Ki
Ki
Ki
Ki
Ki
Ki
jB
cH
cH
"}
(21,1,1) = {"
TK
TK
TK
TK
TK
TK
QO
QO
QO
QO
QO
QO
QO
QO
QO
QO
QO
QO
QO
QO
QO
QO
QO
QO
QO
QO
QO
QO
QO
QO
QO
QO
QO
QO
QO
QO
QO
QO
QO
QO
QO
QO
yq
TK
yq
lJ
lJ
lJ
sV
sV
lJ
lJ
cH
cH
cH
yq
Tq
vC
cH
Tl
Ki
Ki
Ki
Ki
Ki
Ki
Ki
Ki
Ki
Ki
Ki
Ki
jB
cH
cH
"}
(22,1,1) = {"
TK
TK
TK
TK
TK
TK
QO
QO
QO
QO
QO
QO
QO
QO
QO
QO
QO
QO
QO
QO
QO
QO
QO
QO
QO
QO
QO
QO
QO
QO
QO
QO
QO
QO
QO
QO
QO
QO
QO
QO
QO
QO
yq
yq
yq
UW
yq
yq
sV
sV
cH
cH
cH
cH
cH
yq
UW
UW
cH
Tl
Ki
Ki
Ki
Ki
Ki
Ki
Ki
Ki
Ki
Ki
Ki
Ki
jB
cH
cH
"}
(23,1,1) = {"
TK
TK
TK
TK
TK
TK
QO
QO
QO
QO
QO
QO
QO
QO
QO
QO
QO
QO
QO
QO
QO
QO
QO
QO
QO
QO
QO
QO
QO
QO
QO
QO
QO
QO
QO
QO
QO
QO
QO
QO
QO
QO
sV
sV
yq
sV
sV
sV
sV
sV
sV
cH
cH
cH
Tq
cN
yq
Tq
cH
bE
XM
XM
XM
XM
XM
XM
XM
XM
XM
XM
XM
XM
Fy
cH
cH
"}
(24,1,1) = {"
TK
TK
TK
TK
TK
TK
QO
QO
QO
QO
QO
QO
QO
QO
QO
QO
QO
QO
QO
QO
QO
QO
QO
QO
QO
QO
QO
QO
QO
QO
QO
QO
QO
QO
QO
QO
QO
QO
QO
QO
QO
QO
sV
sV
sV
sV
UW
yq
yq
sV
sV
sV
sV
cH
cH
cH
cH
cH
cH
cH
cH
cH
cH
cH
cH
cH
cH
cH
cH
cH
cH
cH
cH
cH
cH
"}
(25,1,1) = {"
TK
TK
TK
TK
TK
TK
QO
QO
QO
QO
QO
QO
QO
QO
QO
QO
QO
QO
QO
QO
QO
QO
QO
QO
QO
QO
QO
QO
QO
QO
QO
QO
QO
QO
QO
QO
QO
QO
QO
QO
QO
QO
sV
sV
sV
yq
yq
yq
yq
sV
sV
sV
sV
sV
qn
cH
cH
cH
cH
cH
cH
cH
Tq
cH
cH
vC
cH
cH
cH
cH
cH
cH
cH
cH
cH
"}
(26,1,1) = {"
TK
TK
TK
TK
TK
TK
QO
QO
QO
QO
QO
QO
QO
QO
QO
QO
QO
QO
QO
QO
QO
QO
QO
QO
QO
QO
QO
QO
QO
QO
QO
QO
QO
QO
QO
QO
QO
QO
QO
QO
QO
QO
sV
yq
yq
yq
TK
TK
yq
sV
sV
sV
sV
sV
sV
cH
cH
cH
cH
cH
cH
cH
cH
cH
cH
cH
cH
cH
cH
cH
cH
cH
cH
cH
cH
"}
(27,1,1) = {"
TK
TK
TK
TK
TK
TK
QO
QO
QO
QO
QO
QO
QO
QO
QO
QO
QO
QO
QO
QO
QO
QO
QO
QO
QO
QO
QO
QO
QO
QO
QO
QO
QO
QO
QO
QO
QO
QO
QO
QO
QO
QO
yq
yq
TK
TK
TK
TK
yq
yq
sV
sV
sV
sV
cH
cH
cH
cH
cH
cH
cH
cH
cH
cH
cH
cH
cH
cH
cH
cH
cH
cH
cH
cH
cH
"}
(28,1,1) = {"
TK
TK
TK
TK
TK
TK
QO
QO
QO
QO
QO
QO
QO
QO
QO
QO
QO
QO
QO
QO
QO
QO
QO
QO
QO
QO
QO
QO
QO
QO
QO
QO
QO
QO
QO
QO
QO
QO
QO
QO
QO
QO
TK
TK
TK
TK
TK
TK
TK
yq
yq
sV
sV
sV
cH
cH
cH
cH
cH
cH
cH
cH
cH
cH
cH
cH
cH
cH
cH
cH
cH
cH
cH
cH
cH
"}
(29,1,1) = {"
TK
TK
TK
TK
TK
TK
QO
QO
QO
QO
QO
QO
QO
QO
QO
QO
QO
QO
QO
QO
QO
QO
QO
QO
QO
QO
QO
QO
QO
QO
QO
QO
QO
QO
QO
QO
QO
QO
QO
QO
QO
QO
TK
TK
TK
TK
TK
TK
TK
TK
yq
yq
yq
sV
cH
cH
cH
cH
cH
cH
cH
cH
cH
cH
cH
cH
cH
cH
cH
cH
cH
cH
cH
cH
cH
"}
(30,1,1) = {"
TK
TK
TK
TK
TK
TK
QO
QO
QO
QO
QO
QO
QO
QO
QO
QO
QO
QO
QO
QO
QO
QO
QO
QO
QO
QO
QO
QO
QO
QO
QO
QO
QO
QO
QO
QO
QO
QO
QO
QO
QO
QO
TK
TK
TK
TK
TK
TK
TK
TK
TK
yq
yq
yq
cH
cH
cH
cH
cH
cH
cH
cH
cH
cH
cH
cH
cH
cH
cH
cH
cH
cH
cH
cH
cH
"}
(31,1,1) = {"
TK
TK
TK
TK
TK
TK
QO
QO
QO
QO
QO
QO
QO
QO
QO
QO
QO
QO
QO
QO
QO
QO
QO
QO
QO
QO
QO
QO
QO
QO
QO
QO
QO
QO
QO
QO
QO
QO
QO
QO
QO
QO
TK
TK
TK
TK
TK
TK
TK
TK
TK
TK
TK
TK
cH
cH
cH
cH
cH
cH
cH
cH
cH
cH
cH
cH
cH
cH
cH
cH
cH
cH
cH
cH
cH
"}
(32,1,1) = {"
TK
TK
TK
TK
TK
TK
QO
QO
QO
QO
QO
QO
QO
QO
QO
QO
QO
QO
QO
QO
QO
QO
QO
QO
QO
QO
QO
QO
QO
QO
QO
QO
QO
QO
QO
QO
QO
QO
QO
QO
QO
QO
TK
TK
TK
TK
TK
TK
TK
TK
TK
TK
TK
TK
cH
cH
cH
cH
cH
cH
cH
cH
cH
cH
cH
cH
cH
cH
cH
cH
cH
cH
cH
cH
cH
"}
(33,1,1) = {"
TK
TK
TK
TK
TK
TK
QO
QO
QO
QO
QO
QO
QO
QO
QO
QO
QO
QO
QO
QO
QO
QO
QO
QO
QO
QO
QO
QO
QO
QO
QO
QO
QO
QO
QO
QO
QO
QO
QO
QO
QO
QO
TK
TK
TK
TK
TK
TK
TK
TK
TK
TK
TK
TK
TK
TK
TK
TK
TK
TK
TK
TK
TK
TK
TK
TK
TK
TK
TK
TK
TK
TK
TK
TK
TK
"}
(34,1,1) = {"
TK
TK
TK
TK
TK
TK
QO
QO
QO
QO
QO
QO
QO
QO
QO
QO
QO
QO
QO
QO
QO
QO
QO
QO
QO
QO
QO
QO
QO
QO
QO
QO
QO
QO
QO
QO
QO
QO
QO
QO
QO
QO
TK
TK
TK
TK
TK
TK
TK
TK
TK
TK
TK
TK
TK
TK
TK
TK
TK
TK
TK
TK
TK
TK
TK
TK
TK
TK
TK
TK
TK
TK
TK
TK
TK
"}
(35,1,1) = {"
TK
TK
TK
TK
TK
TK
QO
QO
QO
QO
QO
QO
QO
QO
QO
QO
QO
QO
QO
QO
QO
QO
QO
QO
QO
QO
QO
QO
QO
QO
QO
QO
QO
QO
QO
QO
QO
QO
QO
QO
QO
QO
TK
TK
TK
TK
TK
TK
TK
TK
TK
TK
TK
TK
TK
TK
TK
TK
TK
TK
TK
TK
TK
TK
TK
TK
TK
TK
TK
TK
TK
TK
TK
TK
TK
"}
(36,1,1) = {"
TK
TK
TK
TK
TK
TK
QO
QO
QO
QO
QO
QO
QO
QO
QO
QO
QO
QO
QO
QO
QO
QO
QO
QO
QO
QO
QO
QO
QO
QO
QO
QO
QO
QO
QO
QO
QO
QO
QO
QO
QO
QO
TK
TK
TK
TK
TK
TK
TK
TK
TK
TK
TK
TK
TK
TK
TK
TK
TK
TK
TK
TK
TK
TK
TK
TK
TK
TK
TK
TK
TK
TK
TK
TK
TK
"}
(37,1,1) = {"
TK
TK
TK
TK
TK
TK
QO
QO
QO
QO
QO
QO
QO
QO
QO
QO
QO
QO
QO
QO
QO
QO
QO
QO
QO
QO
QO
QO
QO
QO
QO
QO
QO
QO
QO
QO
QO
QO
QO
QO
QO
QO
TK
TK
TK
TK
TK
TK
TK
TK
TK
TK
TK
TK
TK
TK
TK
TK
TK
TK
TK
TK
TK
TK
TK
TK
TK
TK
TK
TK
TK
TK
TK
TK
TK
"}
(38,1,1) = {"
TK
TK
TK
TK
TK
TK
QO
QO
QO
QO
QO
QO
QO
QO
QO
QO
QO
QO
QO
QO
QO
QO
QO
QO
QO
QO
QO
QO
QO
QO
QO
QO
QO
QO
QO
QO
QO
QO
QO
QO
QO
QO
TK
TK
TK
TK
TK
TK
TK
TK
TK
TK
TK
TK
TK
TK
TK
TK
TK
TK
TK
TK
TK
TK
TK
TK
TK
TK
TK
TK
TK
TK
TK
TK
TK
"}
(39,1,1) = {"
TK
TK
TK
TK
TK
TK
QO
QO
QO
QO
QO
QO
QO
QO
QO
QO
QO
QO
QO
QO
QO
QO
QO
QO
QO
QO
QO
QO
QO
QO
QO
QO
QO
QO
QO
QO
QO
QO
QO
QO
QO
QO
TK
TK
TK
TK
TK
TK
TK
TK
TK
TK
TK
TK
TK
TK
TK
TK
TK
TK
TK
TK
TK
TK
TK
TK
TK
TK
TK
TK
TK
TK
TK
TK
TK
"}
(40,1,1) = {"
TK
TK
TK
TK
TK
TK
QO
QO
QO
QO
QO
QO
QO
QO
QO
QO
QO
QO
QO
QO
QO
QO
QO
QO
QO
QO
QO
QO
QO
QO
QO
QO
QO
QO
QO
QO
QO
QO
QO
QO
QO
QO
TK
TK
TK
TK
TK
TK
TK
TK
TK
TK
TK
TK
TK
TK
TK
TK
TK
TK
TK
TK
TK
TK
TK
TK
TK
TK
TK
TK
TK
TK
TK
TK
TK
"}
(41,1,1) = {"
TK
TK
TK
TK
TK
TK
QO
QO
QO
QO
QO
QO
QO
QO
QO
QO
QO
QO
QO
QO
QO
QO
QO
QO
QO
QO
QO
QO
QO
QO
QO
QO
QO
QO
QO
QO
QO
QO
QO
QO
QO
QO
TK
TK
TK
TK
TK
TK
TK
TK
TK
TK
TK
TK
TK
TK
TK
TK
TK
TK
TK
TK
TK
TK
TK
TK
TK
TK
TK
TK
TK
TK
TK
TK
TK
"}
(42,1,1) = {"
TK
TK
TK
TK
TK
TK
QO
QO
QO
QO
QO
QO
QO
QO
QO
QO
QO
QO
QO
QO
QO
QO
QO
QO
QO
QO
QO
QO
QO
QO
QO
QO
QO
QO
QO
QO
QO
QO
QO
QO
QO
QO
TK
TK
TK
TK
TK
TK
TK
TK
TK
TK
TK
TK
TK
TK
TK
TK
TK
TK
TK
TK
TK
TK
TK
TK
TK
TK
TK
TK
TK
TK
TK
TK
TK
"}
(43,1,1) = {"
TK
TK
TK
TK
TK
TK
QO
QO
QO
QO
QO
QO
QO
QO
QO
QO
QO
QO
QO
QO
QO
QO
QO
QO
QO
QO
QO
QO
QO
QO
QO
QO
QO
QO
QO
QO
QO
QO
QO
QO
QO
QO
TK
TK
TK
TK
TK
TK
TK
TK
TK
TK
TK
TK
TK
TK
TK
TK
TK
TK
TK
TK
TK
TK
TK
TK
TK
TK
TK
TK
TK
TK
TK
TK
TK
"}
(44,1,1) = {"
TK
TK
TK
TK
TK
TK
QO
QO
QO
QO
QO
QO
QO
QO
QO
QO
QO
QO
QO
QO
QO
QO
QO
QO
QO
QO
QO
QO
QO
QO
QO
QO
QO
QO
QO
QO
QO
QO
QO
QO
QO
QO
TK
TK
TK
TK
TK
TK
TK
TK
TK
TK
TK
TK
TK
TK
TK
TK
TK
TK
TK
TK
TK
TK
TK
TK
TK
TK
TK
TK
TK
TK
TK
TK
TK
"}
(45,1,1) = {"
TK
TK
TK
TK
TK
TK
TK
TK
TK
TK
TK
TK
TK
TK
TK
TK
TK
TK
TK
TK
TK
TK
TK
TK
TK
TK
TK
TK
TK
TK
TK
TK
TK
TK
TK
TK
TK
TK
TK
TK
TK
TK
TK
TK
TK
TK
TK
TK
TK
TK
TK
TK
TK
TK
TK
TK
TK
TK
TK
TK
TK
TK
TK
TK
TK
TK
TK
TK
TK
TK
TK
TK
TK
TK
TK
"}
(46,1,1) = {"
TK
TK
TK
TK
TK
TK
TK
TK
TK
TK
TK
TK
TK
TK
TK
TK
TK
TK
TK
TK
TK
TK
TK
TK
TK
TK
TK
TK
TK
TK
TK
TK
TK
TK
TK
TK
TK
TK
TK
TK
TK
TK
TK
TK
TK
TK
TK
TK
TK
TK
TK
TK
TK
TK
TK
TK
TK
TK
TK
TK
TK
TK
TK
TK
TK
TK
TK
TK
TK
TK
TK
TK
TK
TK
TK
"}
(47,1,1) = {"
TK
TK
TK
TK
TK
TK
TK
TK
TK
TK
TK
TK
TK
TK
TK
TK
TK
TK
TK
TK
TK
TK
TK
TK
TK
TK
TK
TK
TK
TK
TK
TK
TK
TK
TK
TK
TK
TK
TK
TK
TK
TK
TK
TK
TK
TK
TK
TK
TK
TK
TK
TK
TK
TK
TK
TK
TK
TK
TK
TK
TK
TK
TK
TK
TK
TK
TK
TK
TK
TK
TK
TK
TK
TK
TK
"}
(48,1,1) = {"
TK
TK
TK
TK
TK
TK
TK
TK
TK
TK
TK
TK
TK
TK
TK
TK
TK
TK
TK
TK
TK
TK
TK
TK
TK
TK
TK
TK
TK
TK
TK
TK
TK
TK
TK
TK
TK
TK
TK
TK
TK
TK
TK
TK
TK
TK
TK
TK
TK
TK
TK
TK
TK
TK
TK
TK
TK
TK
TK
TK
TK
TK
TK
TK
TK
TK
TK
TK
TK
TK
TK
TK
TK
TK
TK
"}
(49,1,1) = {"
TK
TK
TK
TK
TK
TK
TK
TK
TK
TK
TK
TK
TK
TK
TK
TK
TK
TK
TK
TK
TK
TK
TK
TK
TK
TK
TK
TK
TK
TK
TK
TK
TK
TK
TK
TK
TK
TK
TK
TK
TK
TK
TK
TK
TK
TK
TK
TK
TK
TK
TK
TK
TK
TK
TK
TK
TK
TK
TK
TK
TK
TK
TK
TK
TK
TK
TK
TK
TK
TK
TK
TK
TK
TK
TK
"}
(50,1,1) = {"
TK
TK
TK
TK
TK
TK
TK
TK
TK
TK
TK
TK
TK
TK
TK
TK
TK
TK
TK
TK
TK
TK
TK
TK
TK
TK
TK
TK
TK
TK
TK
TK
TK
TK
TK
TK
TK
TK
TK
TK
TK
TK
TK
TK
TK
TK
TK
TK
TK
TK
TK
TK
TK
TK
TK
TK
TK
TK
TK
TK
TK
TK
TK
TK
TK
TK
TK
TK
TK
TK
TK
TK
TK
TK
TK
"}
(51,1,1) = {"
TK
TK
TK
TK
TK
TK
TK
TK
TK
TK
TK
TK
TK
TK
TK
TK
TK
TK
TK
TK
TK
TK
TK
TK
TK
TK
TK
TK
TK
TK
TK
TK
TK
TK
TK
TK
TK
TK
TK
TK
TK
TK
TK
TK
TK
TK
TK
TK
TK
TK
TK
TK
TK
TK
TK
TK
TK
TK
TK
TK
TK
TK
TK
TK
TK
TK
TK
TK
TK
TK
TK
TK
TK
TK
TK
"}
(52,1,1) = {"
TK
TK
TK
TK
TK
TK
TK
TK
TK
TK
TK
TK
TK
TK
TK
TK
TK
TK
TK
TK
TK
TK
TK
TK
TK
TK
TK
TK
TK
TK
TK
TK
TK
TK
TK
TK
TK
TK
TK
TK
TK
TK
TK
TK
TK
TK
TK
TK
TK
TK
TK
TK
TK
TK
TK
TK
TK
TK
TK
TK
TK
TK
TK
TK
TK
TK
TK
TK
TK
TK
TK
TK
TK
TK
TK
"}
(53,1,1) = {"
TK
TK
TK
TK
TK
TK
TK
TK
TK
TK
TK
TK
TK
TK
TK
TK
TK
TK
TK
TK
TK
TK
TK
TK
TK
TK
TK
TK
TK
TK
TK
TK
TK
TK
TK
TK
TK
TK
TK
TK
TK
TK
TK
TK
TK
TK
TK
TK
TK
TK
TK
TK
TK
TK
TK
TK
TK
TK
TK
TK
TK
TK
TK
TK
TK
TK
TK
TK
TK
TK
TK
TK
TK
TK
TK
"}
(54,1,1) = {"
TK
TK
TK
TK
TK
TK
TK
TK
TK
TK
TK
TK
TK
TK
TK
TK
TK
TK
TK
TK
TK
TK
TK
TK
TK
TK
TK
TK
TK
TK
TK
TK
TK
TK
TK
TK
TK
TK
TK
TK
TK
TK
TK
TK
TK
TK
TK
TK
TK
TK
TK
TK
TK
TK
TK
TK
TK
TK
TK
TK
TK
TK
TK
TK
TK
TK
TK
TK
TK
TK
TK
TK
TK
TK
TK
"}
(55,1,1) = {"
TK
TK
TK
TK
TK
TK
TK
TK
TK
TK
TK
TK
TK
TK
TK
TK
TK
TK
TK
TK
TK
TK
TK
TK
TK
TK
TK
TK
TK
TK
TK
TK
TK
TK
TK
TK
TK
TK
TK
TK
TK
TK
TK
TK
TK
TK
TK
TK
TK
TK
TK
TK
TK
TK
TK
TK
TK
TK
TK
TK
TK
TK
TK
TK
TK
TK
TK
TK
TK
TK
TK
TK
TK
TK
TK
"}
(56,1,1) = {"
TK
TK
TK
TK
TK
TK
TK
TK
TK
TK
TK
TK
TK
TK
TK
TK
TK
TK
TK
TK
TK
TK
TK
TK
TK
TK
TK
TK
TK
TK
TK
TK
TK
TK
TK
TK
TK
TK
TK
TK
TK
TK
TK
TK
TK
TK
TK
TK
TK
TK
TK
TK
TK
TK
TK
TK
TK
TK
TK
TK
TK
TK
TK
TK
TK
TK
TK
TK
TK
TK
TK
TK
TK
TK
TK
"}
(57,1,1) = {"
TK
TK
TK
TK
TK
TK
TK
TK
TK
TK
TK
TK
TK
TK
TK
TK
TK
TK
TK
TK
TK
TK
TK
TK
TK
TK
TK
TK
TK
TK
TK
TK
TK
TK
TK
TK
TK
TK
TK
TK
TK
TK
TK
TK
TK
TK
TK
TK
TK
TK
TK
TK
TK
TK
TK
TK
TK
TK
TK
TK
TK
TK
TK
TK
TK
TK
TK
TK
TK
TK
TK
TK
TK
TK
TK
"}
(58,1,1) = {"
TK
TK
TK
TK
TK
TK
TK
TK
TK
TK
TK
TK
TK
TK
TK
TK
TK
TK
TK
TK
TK
TK
TK
TK
TK
TK
TK
TK
TK
TK
TK
TK
TK
TK
TK
TK
TK
TK
TK
TK
TK
TK
TK
TK
TK
TK
TK
TK
TK
TK
TK
TK
TK
TK
TK
TK
TK
TK
TK
TK
TK
TK
TK
TK
TK
TK
TK
TK
TK
TK
TK
TK
TK
TK
TK
"}
(59,1,1) = {"
TK
TK
TK
TK
TK
TK
TK
TK
TK
TK
TK
TK
TK
TK
TK
TK
TK
TK
TK
TK
TK
TK
TK
TK
TK
TK
TK
TK
TK
TK
TK
TK
TK
TK
TK
TK
TK
TK
TK
TK
TK
TK
TK
TK
TK
TK
TK
TK
TK
TK
TK
TK
TK
TK
TK
TK
TK
TK
TK
TK
TK
TK
TK
TK
TK
TK
TK
TK
TK
TK
TK
TK
TK
TK
TK
"}
(60,1,1) = {"
TK
TK
TK
TK
TK
TK
TK
TK
TK
TK
TK
TK
TK
TK
TK
TK
TK
TK
TK
TK
TK
TK
TK
TK
TK
TK
TK
TK
TK
TK
TK
TK
TK
TK
TK
TK
TK
TK
TK
TK
TK
TK
TK
TK
TK
TK
TK
TK
TK
TK
TK
TK
TK
TK
TK
TK
TK
TK
TK
TK
TK
TK
TK
TK
TK
TK
TK
TK
TK
TK
TK
TK
TK
TK
TK
"}
(61,1,1) = {"
TK
TK
TK
TK
TK
TK
TK
TK
TK
TK
TK
TK
TK
TK
TK
TK
TK
TK
TK
TK
TK
TK
TK
TK
TK
TK
TK
TK
TK
TK
TK
TK
TK
TK
TK
TK
TK
TK
TK
TK
TK
TK
TK
TK
TK
TK
TK
TK
TK
TK
TK
TK
TK
TK
TK
TK
TK
TK
TK
TK
TK
TK
TK
TK
TK
TK
TK
TK
TK
TK
TK
TK
TK
TK
TK
"}
(62,1,1) = {"
TK
TK
TK
TK
TK
TK
TK
TK
TK
TK
TK
TK
TK
TK
TK
TK
TK
TK
TK
TK
TK
TK
TK
TK
TK
TK
TK
TK
TK
TK
TK
TK
TK
TK
TK
TK
TK
TK
TK
TK
TK
TK
TK
TK
TK
TK
TK
TK
TK
TK
TK
TK
TK
TK
TK
TK
TK
TK
TK
TK
TK
TK
TK
TK
TK
TK
TK
TK
TK
TK
TK
TK
TK
TK
TK
"}
(63,1,1) = {"
TK
TK
TK
TK
TK
TK
TK
TK
TK
TK
TK
TK
TK
TK
TK
TK
TK
TK
TK
TK
TK
TK
TK
TK
TK
TK
TK
TK
TK
TK
TK
TK
TK
TK
TK
TK
TK
TK
TK
TK
TK
TK
TK
TK
TK
TK
TK
TK
TK
TK
TK
TK
TK
TK
TK
TK
TK
TK
TK
TK
TK
TK
TK
TK
TK
TK
TK
TK
TK
TK
TK
TK
TK
TK
TK
"}
(64,1,1) = {"
TK
TK
TK
TK
TK
TK
TK
TK
TK
TK
TK
TK
TK
TK
TK
TK
TK
TK
TK
TK
TK
TK
TK
TK
TK
TK
TK
TK
TK
TK
TK
TK
TK
TK
TK
TK
TK
TK
TK
TK
TK
TK
TK
TK
TK
TK
TK
TK
TK
TK
TK
TK
TK
TK
TK
TK
TK
TK
TK
TK
TK
TK
TK
TK
TK
TK
TK
TK
TK
TK
TK
TK
TK
TK
TK
"}
(65,1,1) = {"
TK
TK
TK
TK
TK
TK
TK
TK
TK
TK
TK
TK
TK
TK
TK
TK
TK
TK
TK
TK
TK
TK
TK
TK
TK
TK
TK
TK
TK
TK
TK
TK
TK
TK
TK
TK
TK
TK
TK
TK
TK
TK
TK
TK
TK
TK
TK
TK
TK
TK
TK
TK
TK
TK
TK
TK
TK
TK
TK
TK
TK
TK
TK
TK
TK
TK
TK
TK
TK
TK
TK
TK
TK
TK
TK
"}
(66,1,1) = {"
TK
TK
TK
TK
TK
TK
TK
TK
TK
TK
TK
TK
TK
TK
TK
TK
TK
TK
TK
TK
TK
TK
TK
TK
TK
TK
TK
TK
TK
TK
TK
TK
TK
TK
TK
TK
TK
TK
TK
TK
TK
TK
TK
TK
TK
TK
TK
TK
TK
TK
TK
TK
TK
TK
TK
TK
TK
TK
TK
TK
TK
TK
TK
TK
TK
TK
TK
TK
TK
TK
TK
TK
TK
TK
TK
"}
(67,1,1) = {"
TK
TK
TK
TK
TK
TK
TK
TK
TK
TK
TK
TK
TK
TK
TK
TK
TK
TK
TK
TK
TK
TK
TK
TK
TK
TK
TK
TK
TK
TK
TK
TK
TK
TK
TK
TK
TK
TK
TK
TK
TK
TK
TK
TK
TK
TK
TK
TK
TK
TK
TK
TK
TK
TK
TK
TK
TK
TK
TK
TK
TK
TK
TK
TK
TK
TK
TK
TK
TK
TK
TK
TK
TK
TK
TK
"}
(68,1,1) = {"
TK
TK
TK
TK
TK
TK
TK
TK
TK
TK
TK
TK
TK
TK
TK
TK
TK
TK
TK
TK
TK
TK
TK
TK
TK
TK
TK
TK
TK
TK
TK
TK
TK
TK
TK
TK
TK
TK
TK
TK
TK
TK
TK
TK
TK
TK
TK
TK
TK
TK
TK
TK
TK
TK
TK
TK
TK
TK
TK
TK
TK
TK
TK
TK
TK
TK
TK
TK
TK
TK
TK
TK
TK
TK
TK
"}
(69,1,1) = {"
TK
TK
TK
TK
TK
TK
TK
TK
TK
TK
TK
TK
TK
TK
TK
TK
TK
TK
TK
TK
TK
TK
TK
TK
TK
TK
TK
TK
TK
TK
TK
TK
TK
TK
TK
TK
TK
TK
TK
TK
TK
TK
TK
TK
TK
TK
TK
TK
TK
TK
TK
TK
TK
TK
TK
TK
TK
TK
TK
TK
TK
TK
TK
TK
TK
TK
TK
TK
TK
TK
TK
TK
TK
TK
TK
"}
(70,1,1) = {"
TK
TK
TK
TK
TK
TK
TK
TK
TK
TK
TK
TK
TK
TK
TK
TK
TK
TK
TK
TK
TK
TK
TK
TK
TK
TK
TK
TK
TK
TK
TK
TK
TK
TK
TK
TK
TK
TK
TK
TK
TK
TK
TK
TK
TK
TK
TK
TK
TK
TK
TK
TK
TK
TK
TK
TK
TK
TK
TK
TK
TK
TK
TK
TK
TK
TK
TK
TK
TK
TK
TK
TK
TK
TK
TK
"}
(71,1,1) = {"
TK
TK
TK
TK
TK
TK
TK
TK
TK
TK
TK
TK
TK
TK
TK
TK
TK
TK
TK
TK
TK
TK
TK
TK
TK
TK
TK
TK
TK
TK
TK
TK
TK
TK
TK
TK
TK
TK
TK
TK
TK
TK
TK
TK
TK
TK
TK
TK
TK
TK
TK
TK
TK
TK
TK
TK
TK
TK
TK
TK
TK
TK
TK
TK
TK
TK
TK
TK
TK
TK
TK
TK
TK
TK
TK
"}
(72,1,1) = {"
TK
TK
TK
TK
TK
TK
TK
TK
TK
TK
TK
TK
TK
TK
TK
TK
TK
TK
TK
TK
TK
TK
TK
TK
TK
TK
TK
TK
TK
TK
TK
TK
TK
TK
TK
TK
TK
TK
TK
TK
TK
TK
TK
TK
TK
TK
TK
TK
TK
TK
TK
TK
TK
TK
TK
TK
TK
TK
TK
TK
TK
TK
TK
TK
TK
TK
TK
TK
TK
TK
TK
TK
TK
TK
TK
"}
(73,1,1) = {"
TK
TK
TK
TK
TK
TK
TK
TK
TK
TK
TK
TK
TK
TK
TK
TK
TK
TK
TK
TK
TK
TK
TK
TK
TK
TK
TK
TK
TK
TK
TK
TK
TK
TK
TK
TK
TK
TK
TK
TK
TK
TK
TK
TK
TK
TK
TK
TK
TK
TK
TK
TK
TK
TK
TK
TK
TK
TK
TK
TK
TK
TK
TK
TK
TK
TK
TK
TK
TK
TK
TK
TK
TK
TK
TK
"}
(74,1,1) = {"
TK
TK
TK
TK
TK
TK
TK
TK
TK
TK
TK
TK
TK
TK
TK
TK
TK
TK
TK
TK
TK
TK
TK
TK
TK
TK
TK
TK
TK
TK
TK
TK
TK
TK
TK
TK
TK
TK
TK
TK
TK
TK
TK
TK
TK
TK
TK
TK
TK
TK
TK
TK
TK
TK
TK
TK
TK
TK
TK
TK
TK
TK
TK
TK
TK
TK
TK
TK
TK
TK
TK
TK
TK
TK
TK
"}
(75,1,1) = {"
TK
TK
TK
TK
TK
TK
TK
TK
TK
TK
TK
TK
TK
TK
TK
TK
TK
TK
TK
TK
TK
TK
TK
TK
TK
TK
TK
TK
TK
TK
TK
TK
TK
TK
TK
TK
TK
TK
TK
TK
TK
TK
TK
TK
TK
TK
TK
TK
TK
TK
TK
TK
TK
TK
TK
TK
TK
TK
TK
TK
TK
TK
TK
TK
TK
TK
TK
TK
TK
TK
TK
TK
TK
TK
TK
"}
