//MAP CONVERTED BY dmm2tgm.py THIS HEADER COMMENT PREVENTS RECONVERSION, DO NOT REMOVE
"as" = (
/turf/simulated/floor/engine,
/area/space)
"cv" = (
/turf/space,
/area/space)
"cU" = (
/obj/machinery/door/airlock/titanium/glass,
/obj/structure/fans/tiny,
/turf/simulated/floor/mineral/titanium,
/area/space)
"df" = (
/obj/effect/spawner/random_spawners/wall_rusted_maybe,
/turf/simulated/floor/plasteel/goonplaque/memorial,
/area/space)
"do" = (
/obj/structure/table/reinforced,
/obj/item/food/snacks/carrotfries,
/obj/item/seeds/coffee{
	pixel_x = 4;
	pixel_y = -2
	},
/turf/simulated/floor/plasteel,
/area/space)
"du" = (
/obj/effect/spawner/random_spawners/wall_rusted_maybe,
/turf/simulated/floor/plasteel,
/area/space)
"eh" = (
/obj/structure/cable{
	d1 = 1;
	d2 = 2;
	icon_state = "1-2"
	},
/turf/simulated/floor/engine,
/area/space)
"em" = (
/obj/machinery/door/airlock/titanium/glass,
/obj/structure/fans/tiny,
/turf/simulated/floor/plasteel,
/area/space)
"es" = (
/turf/simulated/floor/plasteel,
/area/space)
"eu" = (
/obj/machinery/door/window/classic/reversed{
	name = "Animal Storage";
	dir = 1
	},
/turf/simulated/floor/plasteel,
/area/space)
"ez" = (
/obj/machinery/hydroponics/constructable,
/turf/simulated/floor/plasteel,
/area/space)
"eC" = (
/obj/structure/window/reinforced{
	dir = 8
	},
/obj/effect/spawner/random_spawners/wall_rusted_maybe,
/turf/simulated/floor/plasteel,
/area/space)
"fQ" = (
/obj/structure/girder,
/obj/item/stack/sheet/mineral/titanium,
/turf,
/area/space)
"gl" = (
/obj/structure/flora/ausbushes/ppflowers,
/turf/simulated/floor/grass,
/area/space)
"gp" = (
/obj/structure/cable{
	d1 = 2;
	d2 = 4;
	icon_state = "2-4"
	},
/turf/simulated/floor/engine,
/area/space)
"gw" = (
/obj/machinery/computer/nonfunctional{
	dir = 1
	},
/turf/simulated/floor/plasteel,
/area/space)
"gG" = (
/obj/structure/girder,
/turf,
/area/space)
"hb" = (
/obj/structure/table/reinforced,
/obj/effect/spawner/lootdrop/maintenance,
/turf/simulated/floor/transparent/glass,
/area/space)
"hW" = (
/obj/structure/cable{
	d1 = 1;
	d2 = 8;
	icon_state = "1-8"
	},
/obj/effect/landmark/damageturf,
/turf/simulated/floor/engine,
/area/space)
"hY" = (
/obj/structure/cable{
	d2 = 4;
	icon_state = "0-4"
	},
/obj/machinery/power/smes/magical,
/turf/simulated/floor/engine,
/area/space)
"iL" = (
/obj/machinery/economy/vending/hydronutrients,
/turf/simulated/floor/plasteel,
/area/space)
"iP" = (
/turf/simulated/floor/transparent/glass,
/area/space)
"jv" = (
/obj/effect/spawner/random_spawners/wall_rusted_maybe,
/turf/simulated/wall/mineral/titanium/interior,
/area/space)
"jA" = (
/obj/structure/cable{
	d1 = 1;
	d2 = 2;
	icon_state = "1-2";
	tag = ""
	},
/obj/effect/spawner/window/reinforced,
/turf/simulated/floor/engine,
/area/space)
"kE" = (
/obj/machinery/seed_extractor,
/turf/simulated/floor/plasteel,
/area/space)
"mi" = (
/turf,
/area/space)
"mG" = (
/obj/structure/window/reinforced{
	dir = 8
	},
/turf/simulated/floor/plasteel,
/area/space)
"mH" = (
/mob/living/simple_animal/cow,
/turf/simulated/floor/grass,
/area/space)
"mJ" = (
/obj/structure/closet/crate,
/obj/item/stack/sheet/mineral/plasma/fifty,
/obj/item/stack/sheet/mineral/gold/fifty,
/obj/item/stack/sheet/mineral/bananium/ten,
/turf/simulated/floor/engine,
/area/space)
"nV" = (
/obj/structure/table/reinforced,
/obj/effect/spawner/lootdrop/maintenance,
/turf/simulated/floor/plasteel,
/area/space)
"oC" = (
/obj/structure/table/reinforced,
/obj/item/storage/box/beakers,
/obj/item/storage/box/beakers,
/obj/item/reagent_containers/dropper,
/obj/item/storage/box/beakers{
	pixel_x = 2;
	pixel_y = 2
	},
/turf/simulated/floor/plasteel,
/area/space)
"oG" = (
/obj/effect/spawner/airlock{
	req_access_txt = 0
	},
/turf/simulated/wall/mineral/titanium/interior,
/area/space)
"pI" = (
/obj/structure/table,
/obj/item/seeds/ambrosia/gaia{
	pixel_x = 5
	},
/obj/item/seeds/ambrosia/deus,
/obj/item/seeds/wheat{
	pixel_x = -10;
	pixel_y = 2
	},
/obj/item/seeds/wheat{
	pixel_x = -10;
	pixel_y = 2
	},
/obj/item/seeds/wheat{
	pixel_x = -10;
	pixel_y = 2
	},
/obj/item/seeds/wheat{
	pixel_x = -10
	},
/obj/item/seeds/apple{
	pixel_x = 3;
	pixel_y = 10
	},
/turf/simulated/floor/plasteel,
/area/space)
"qo" = (
/obj/effect/landmark/damageturf,
/obj/machinery/shieldwallgen/on,
/obj/structure/cable,
/turf/simulated/floor/engine,
/area/space)
"rW" = (
/obj/structure/table/reinforced,
/obj/machinery/kitchen_machine/microwave,
/turf/simulated/floor/plasteel,
/area/space)
"sy" = (
/obj/structure/window/reinforced,
/turf/simulated/floor/plasteel,
/area/space)
"sO" = (
/obj/structure/sign/nosmoking_1,
/turf/simulated/wall/mineral/titanium/interior,
/area/space)
"tu" = (
/obj/structure/table/reinforced,
/obj/item/storage/fancy/donut_box,
/turf/simulated/floor/transparent/glass,
/area/space)
"tN" = (
/obj/structure/closet/crate/hydroponics,
/obj/item/plant_analyzer,
/obj/item/clothing/glasses/hud/hydroponic{
	pixel_y = 8
	},
/obj/item/shovel,
/obj/item/cultivator,
/obj/item/storage/bag/plants,
/turf/simulated/floor/plasteel,
/area/space)
"uq" = (
/obj/structure/cable{
	d1 = 2;
	d2 = 8;
	icon_state = "2-8"
	},
/turf/simulated/floor/engine,
/area/space)
"us" = (
/obj/item/stack/spacecash/c100,
/obj/item/stack/spacecash/c100,
/obj/item/coin/silver{
	pixel_x = 4;
	pixel_y = 8
	},
/obj/item/coin/silver{
	pixel_x = 4;
	pixel_y = 8
	},
/obj/item/coin/silver{
	pixel_x = 4;
	pixel_y = 8
	},
/obj/structure/closet/crate,
/obj/item/grenade/spawnergrenade/feral_cats,
/turf/simulated/floor/engine,
/area/space)
"uJ" = (
/obj/structure/table/reinforced,
/turf/simulated/floor/transparent/glass,
/area/space)
"vE" = (
/obj/structure/flora/tree/jungle/small,
/turf/simulated/floor/grass,
/area/space)
"vM" = (
/obj/structure/window/reinforced{
	dir = 1;
	layer = 2.9
	},
/turf/simulated/floor/plasteel,
/area/space)
"wo" = (
/obj/structure/reagent_dispensers/beerkeg/nuke{
	name = "Nanotrasen-brand nuclear fizz-sion explosive"
	},
/turf/simulated/floor/engine,
/area/space)
"wG" = (
/obj/machinery/shieldwallgen/on,
/obj/structure/cable{
	d2 = 2;
	icon_state = "0-2";
	pixel_y = 1
	},
/turf/simulated/floor/engine,
/area/space)
"xm" = (
/mob/living/simple_animal/pet/cat{
	name = "Lenny"
	},
/turf/simulated/floor/plasteel,
/area/space)
"xt" = (
/obj/structure/cable{
	d1 = 1;
	d2 = 2;
	icon_state = "1-2"
	},
/obj/effect/landmark/damageturf,
/turf/simulated/floor/engine,
/area/space)
"xx" = (
/turf/simulated/floor/grass,
/area/space)
"zc" = (
/obj/structure/table/reinforced,
/obj/item/storage/secure/briefcase{
	desc = "A large briefcase with a digital locking system, and the Nanotrasen logo emblazoned on the sides.";
	name = "\improper Nanotrasen-brand secure briefcase exhibit"
	},
/turf/simulated/floor/plasteel,
/area/space)
"zl" = (
/obj/structure/sign/nanotrasen,
/turf/simulated/wall/mineral/titanium/interior,
/area/space)
"zy" = (
/obj/machinery/optable,
/turf/simulated/floor/plasteel,
/area/space)
"zz" = (
/obj/effect/decal/cleanable/blood,
/obj/effect/mob_spawn/human/corpse/scientist{
	outfit = /datum/outfit/tadeus_researcher
	},
/turf/simulated/floor/plasteel,
/area/space)
"zV" = (
/obj/structure/sign/xenobio,
/turf/simulated/wall/mineral/titanium/interior,
/area/space)
"As" = (
/obj/structure/sign/securearea,
/turf/simulated/wall/mineral/titanium/interior,
/area/space)
"AQ" = (
/obj/structure/sign/biohazard,
/obj/effect/spawner/random_spawners/wall_rusted_maybe,
/turf/simulated/wall/mineral/titanium/interior,
/area/space)
"Bt" = (
/mob/living/simple_animal/chicken,
/turf/simulated/floor/plasteel,
/area/space)
"Cd" = (
/obj/structure/table/reinforced,
/obj/item/screwdriver,
/turf/simulated/floor/plasteel,
/area/space)
"CS" = (
/obj/effect/decal/cleanable/blood,
/turf/simulated/floor/plasteel,
/area/space)
"Dl" = (
/obj/machinery/door/window/classic/reversed{
	name = "Animal Storage"
	},
/turf/simulated/floor/plasteel,
/area/space)
"DT" = (
/turf/simulated/wall/mineral/titanium/nodiagonal,
/area/space)
"Ec" = (
/obj/machinery/hydroponics/constructable,
/turf/simulated/floor/grass,
/area/space)
"Ei" = (
/obj/item/card/id/away/old/sci{
	name = "Tadeus Researcher ID"
	},
/turf/simulated/floor/plasteel,
/area/space)
"Fa" = (
/obj/structure/flora/ausbushes/palebush,
/obj/machinery/atmospherics/pipe/simple/hidden{
	dir = 4
	},
/turf/simulated/floor/grass,
/area/space)
"Fi" = (
/obj/structure/sink{
	dir = 4;
	pixel_x = 11
	},
/obj/item/reagent_containers/glass/bucket,
/turf/simulated/floor/plasteel,
/area/space)
"Fy" = (
/obj/structure/cable{
	d1 = 4;
	d2 = 8;
	icon_state = "4-8"
	},
/turf/simulated/floor/engine,
/area/space)
"GO" = (
/obj/machinery/door/airlock/highsecurity{
	name = "High Risk Organisms";
	req_access_txt = "271"
	},
/obj/effect/mapping_helpers/airlock/access/any/science/research{
	access = 271
	},
/obj/structure/fans/tiny,
/turf/simulated/floor/plasteel,
/area/space)
"GT" = (
/obj/machinery/computer/operating,
/turf/simulated/floor/plasteel,
/area/space)
"GX" = (
/obj/structure/table/reinforced,
/obj/item/radio/off,
/turf/simulated/floor/plasteel,
/area/space)
"Hf" = (
/obj/structure/table/reinforced,
/obj/item/paper_bin/nanotrasen,
/obj/item/pen/multi/fountain,
/obj/structure/noticeboard{
	dir = 8;
	pixel_x = 32
	},
/turf/simulated/floor/plasteel,
/area/space)
"Hu" = (
/obj/structure/sign/botany,
/turf/simulated/wall/mineral/titanium/interior,
/area/space)
"Hw" = (
/obj/structure/cable{
	d1 = 2;
	d2 = 8;
	icon_state = "2-8"
	},
/obj/structure/cable{
	d1 = 1;
	d2 = 8;
	icon_state = "1-8"
	},
/turf/simulated/floor/engine,
/area/space)
"HS" = (
/obj/machinery/power/apc/directional/south,
/obj/structure/cable,
/obj/structure/cable{
	d1 = 1;
	d2 = 4;
	icon_state = "1-4"
	},
/obj/structure/cable{
	d1 = 4;
	d2 = 8;
	icon_state = "4-8"
	},
/turf/simulated/floor/engine,
/area/space)
"Io" = (
/obj/machinery/door/airlock/highsecurity{
	name = "High Risk Organisms";
	req_access_txt = "271"
	},
/obj/effect/mapping_helpers/airlock/access/any/science/research{
	access = 271
	},
/turf/simulated/floor/engine,
/area/space)
"Je" = (
/obj/structure/table/reinforced,
/obj/item/wrench,
/turf/simulated/floor/plasteel,
/area/space)
"Jm" = (
/obj/effect/landmark/damageturf,
/turf/simulated/floor/engine,
/area/space)
"JF" = (
/obj/effect/spawner/window/reinforced,
/turf/simulated/floor/plating,
/area/space)
"Kj" = (
/obj/structure/closet/crate/can,
/turf/simulated/floor/plasteel,
/area/space)
"Kv" = (
/obj/structure/cable{
	d1 = 1;
	d2 = 2;
	icon_state = "1-2";
	tag = ""
	},
/turf/simulated/floor/engine,
/area/space)
"La" = (
/obj/structure/table/reinforced,
/obj/item/storage/box/donkpockets,
/turf/simulated/floor/plasteel,
/area/space)
"Mn" = (
/mob/living/simple_animal/seal,
/turf/simulated/floor/grass,
/area/space)
"Mo" = (
/turf/simulated/wall/mineral/titanium/interior,
/area/space)
"Mq" = (
/obj/effect/mob_spawn/human/alive/skeleton,
/turf/simulated/floor/engine,
/area/space)
"MO" = (
/obj/structure/cable{
	d1 = 1;
	d2 = 4;
	icon_state = "1-4"
	},
/obj/structure/cable{
	d1 = 2;
	d2 = 4;
	icon_state = "2-4"
	},
/turf/simulated/floor/engine,
/area/space)
"NW" = (
/obj/machinery/floodlight,
/turf/simulated/floor/plasteel,
/area/space)
"Oh" = (
/obj/effect/landmark/damageturf,
/turf/simulated/floor/grass,
/area/space)
"Ot" = (
/obj/machinery/power/terminal,
/turf/simulated/floor/engine,
/area/space)
"OE" = (
/obj/structure/window/reinforced{
	dir = 4
	},
/obj/effect/spawner/random_spawners/wall_rusted_maybe,
/turf/simulated/floor/plasteel,
/area/space)
"OF" = (
/obj/structure/table,
/obj/item/food/snacks/grown/mushroom/walkingmushroom,
/turf/simulated/floor/plasteel,
/area/space)
"OL" = (
/obj/structure/table/reinforced,
/obj/item/reagent_containers/syringe,
/obj/item/reagent_containers/syringe,
/obj/item/reagent_containers/syringe{
	pixel_y = 10;
	pixel_x = -5
	},
/obj/item/reagent_containers/syringe{
	pixel_x = 3;
	pixel_y = -2
	},
/obj/item/reagent_containers/syringe{
	pixel_y = 5
	},
/turf/simulated/floor/plasteel,
/area/space)
"Pd" = (
/obj/structure/window/reinforced{
	dir = 8
	},
/obj/machinery/atmospherics/pipe/simple/hidden{
	dir = 4
	},
/turf/simulated/floor/plasteel,
/area/space)
"Pn" = (
/obj/structure/sign/biohazard,
/turf/simulated/wall/mineral/titanium/interior,
/area/space)
"Py" = (
/obj/structure/table/reinforced,
/obj/item/paper_bin/nanotrasen,
/obj/structure/noticeboard{
	dir = 4;
	pixel_x = -32
	},
/turf/simulated/floor/plasteel,
/area/space)
"PL" = (
/obj/structure/alien/weeds/node,
/turf/simulated/floor/engine,
/area/space)
"PS" = (
/obj/structure/table/reinforced,
/turf/simulated/floor/light{
	color = "#763C3A"
	},
/area/space)
"Qq" = (
/obj/structure/window/reinforced{
	dir = 4
	},
/turf/simulated/floor/plasteel,
/area/space)
"QL" = (
/mob/living/simple_animal/hostile/alien/drone,
/turf/simulated/floor/engine,
/area/space)
"QM" = (
/mob/living/simple_animal/goose,
/turf/simulated/floor/grass,
/area/space)
"RX" = (
/obj/structure/reagent_dispensers/watertank/high,
/turf/simulated/floor/plasteel,
/area/space)
"Su" = (
/obj/structure/table/reinforced,
/obj/item/paper/crumpled{
	info = "<center><logo><b>Glory to Nanotrasen</b> <br>2988-09-15, 06:17<i><center><station>Epsilion Eridani</center></i><h3>Tadeus Research Objectives</h3></center><hr>From: Rupert Reynolds, Nanotrasen Field Officer<hr>To The Tadeus Station Research Team,<br>You are hereby deployed to the Tadeus Research Station. Your primary mission is to rigorously analyze the biological and botanical samples provided to you. This fax grants you explicit authorization to conduct thorough examinations and execute experimental procedures of a dubious nature, within the confines of necessity. However, be advised: any findings or actions that jeopardize the interests of Nanotrasen will be met with swift and severe repercussions. Your adherence to this mission is vital and if we discover any sway in your alliegence, <i> you will be dealt with.</i><br><br><small><i>Good luck, <br></small></i><small><i>Rupert Reynolds, Nanotrasen Field Officer</i></small><hr><small><i>*This fax message and any accompanying documents are confidential and intended solely for the use of the individual or entity to whom they are addressed. If you are not the intended recipient, any disclosure, reproduction, distribution, or other use of this information is strictly prohibited.If you have received this message in error, please notify the sender immediately and permanently delete the original and any copies from your system.<br>Death to the Syndicate.<br>Glory to Nanotrasen.";
	name = "Tadeus Station Orders"
	},
/turf/simulated/floor/transparent/glass,
/area/space)
"SD" = (
/obj/structure/table,
/obj/item/seeds/plump/walkingmushroom,
/obj/item/seeds/plump{
	pixel_y = -5;
	pixel_x = 3
	},
/obj/item/seeds/pineapple,
/obj/item/seeds/grass{
	pixel_x = 5;
	pixel_y = 7
	},
/turf/simulated/floor/plasteel,
/area/space)
"SQ" = (
/obj/structure/table/reinforced,
/obj/item/folder/white,
/turf/simulated/floor/plasteel,
/area/space)
"Tq" = (
/obj/effect/landmark/damageturf,
/obj/machinery/shieldwallgen/on,
/obj/structure/cable{
	d2 = 2;
	icon_state = "0-2";
	pixel_y = 1
	},
/turf/simulated/floor/engine,
/area/space)
"UE" = (
/obj/structure/cable{
	d1 = 1;
	d2 = 8;
	icon_state = "1-8"
	},
/obj/structure/cable{
	d1 = 4;
	d2 = 8;
	icon_state = "4-8"
	},
/turf/simulated/floor/engine,
/area/space)
"Vb" = (
/obj/structure/chair/office/light{
	dir = 4
	},
/turf/simulated/floor/transparent/glass,
/area/space)
"Vk" = (
/obj/item/storage/secure/briefcase{
	desc = "A large briefcase with a digital locking system, and the Nanotrasen logo emblazoned on the sides.";
	name = "\improper Nanotrasen-brand secure briefcase exhibit"
	},
/obj/structure/table/reinforced,
/turf/simulated/floor/transparent/glass,
/area/space)
"VT" = (
/obj/structure/chair/office/light{
	dir = 8
	},
/turf/simulated/floor/plasteel,
/area/space)
"WO" = (
/obj/structure/table/reinforced,
/obj/item/storage/surgical_tray,
/turf/simulated/floor/plasteel,
/area/space)
"Xn" = (
/mob/living/simple_animal/pig,
/turf/simulated/floor/grass,
/area/space)
"Yr" = (
/obj/structure/table/reinforced,
/obj/item/folder/yellow,
/obj/item/clothing/mask/cigarette/pipe,
/turf/simulated/floor/plasteel,
/area/space)
"YQ" = (
/obj/machinery/shieldwallgen/on,
/obj/structure/cable,
/turf/simulated/floor/engine,
/area/space)
"Zl" = (
/obj/item/toy/nuke,
/turf/simulated/floor/engine,
/area/space)
"ZD" = (
/obj/machinery/atmospherics/pipe/simple/hidden{
	dir = 10;
	initialize_directions = 10
	},
/obj/effect/spawner/random_spawners/wall_rusted_maybe,
/turf/simulated/floor/plasteel,
/area/space)

(1,1,1) = {"
cv
cv
cv
cv
cv
cv
cv
cv
cv
cv
cv
cv
cv
cv
cv
cv
cv
cv
cv
cv
cv
cv
cv
cv
cv
cv
cv
cv
cv
cv
cv
cv
cv
cv
cv
cv
cv
cv
cv
cv
cv
cv
cv
cv
"}
(2,1,1) = {"
cv
cv
cv
cv
cv
cv
cv
cv
cv
cv
cv
cv
cv
cv
cv
cv
cv
cv
cv
cv
cv
cv
cv
cv
cv
cv
cv
cv
cv
cv
cv
cv
cv
cv
cv
cv
cv
cv
cv
cv
cv
cv
cv
cv
"}
(3,1,1) = {"
cv
cv
cv
cv
cv
cv
cv
cv
cv
cv
cv
cv
cv
cv
cv
cv
cv
cv
cv
cv
cv
cv
cv
cv
cv
cv
cv
cv
cv
cv
cv
cv
cv
cv
cv
cv
cv
cv
cv
cv
cv
cv
cv
cv
"}
(4,1,1) = {"
cv
cv
cv
cv
cv
cv
cv
cv
cv
cv
cv
cv
cv
cv
cv
cv
cv
cv
cv
cv
cv
cv
cv
cv
cv
cv
cv
cv
cv
cv
cv
cv
cv
cv
cv
cv
cv
cv
cv
cv
cv
cv
cv
cv
"}
(5,1,1) = {"
cv
cv
cv
cv
cv
cv
cv
cv
cv
cv
cv
cv
cv
cv
cv
cv
cv
cv
cv
cv
cv
cv
cv
cv
cv
cv
cv
cv
cv
cv
cv
cv
cv
cv
cv
cv
cv
cv
cv
cv
cv
cv
cv
cv
"}
(6,1,1) = {"
cv
cv
cv
cv
cv
cv
cv
cv
cv
cv
cv
cv
cv
cv
cv
cv
cv
cv
cv
cv
cv
cv
cv
cv
cv
cv
cv
cv
cv
cv
cv
cv
cv
cv
cv
cv
cv
cv
cv
cv
cv
cv
cv
cv
"}
(7,1,1) = {"
cv
cv
cv
cv
cv
cv
cv
cv
cv
cv
cv
cv
cv
cv
cv
cv
cv
cv
cv
cv
cv
cv
cv
cv
cv
cv
cv
cv
cv
cv
cv
cv
cv
cv
cv
cv
cv
cv
cv
cv
cv
cv
cv
cv
"}
(8,1,1) = {"
cv
cv
cv
cv
cv
cv
cv
cv
cv
cv
cv
cv
cv
cv
cv
cv
cv
cv
cv
cv
cv
cv
cv
cv
cv
cv
cv
cv
cv
cv
cv
cv
cv
cv
cv
cv
cv
cv
cv
cv
cv
cv
cv
cv
"}
(9,1,1) = {"
cv
cv
cv
cv
cv
cv
cv
cv
cv
cv
cv
cv
cv
cv
cv
cv
cv
cv
cv
cv
cv
cv
cv
cv
cv
cv
cv
cv
cv
cv
cv
cv
cv
cv
cv
cv
cv
cv
cv
cv
cv
cv
cv
cv
"}
(10,1,1) = {"
cv
cv
cv
cv
cv
cv
cv
cv
cv
cv
cv
cv
cv
cv
cv
cv
cv
cv
cv
cv
cv
cv
cv
cv
cv
cv
cv
cv
cv
cv
cv
cv
cv
cv
cv
cv
cv
cv
cv
cv
cv
cv
cv
cv
"}
(11,1,1) = {"
cv
cv
cv
cv
cv
cv
cv
cv
cv
cv
cv
cv
cv
cv
cv
cv
cv
cv
cv
cv
cv
cv
cv
cv
cv
cv
cv
cv
cv
cv
cv
cv
cv
cv
cv
cv
cv
cv
cv
cv
cv
cv
cv
cv
"}
(12,1,1) = {"
cv
cv
cv
cv
cv
cv
cv
cv
cv
cv
cv
cv
cv
cv
cv
cv
cv
cv
cv
cv
cv
cv
cv
cv
cv
cv
cv
cv
cv
cv
cv
cv
cv
cv
cv
cv
cv
cv
cv
cv
cv
cv
cv
cv
"}
(13,1,1) = {"
cv
cv
cv
cv
cv
cv
cv
cv
cv
cv
cv
cv
cv
cv
cv
cv
cv
cv
cv
cv
cv
cv
cv
cv
cv
cv
cv
cv
cv
cv
cv
cv
cv
cv
cv
cv
cv
cv
cv
cv
cv
cv
cv
cv
"}
(14,1,1) = {"
cv
cv
cv
cv
cv
cv
cv
cv
cv
cv
cv
cv
cv
cv
cv
cv
cv
cv
cv
cv
cv
cv
cv
cv
cv
cv
cv
cv
cv
cv
cv
cv
cv
cv
cv
cv
cv
cv
cv
cv
cv
cv
cv
cv
"}
(15,1,1) = {"
cv
cv
cv
cv
cv
cv
cv
cv
cv
cv
cv
cv
cv
cv
cv
cv
cv
cv
cv
cv
cv
cv
cv
cv
cv
cv
cv
cv
cv
cv
cv
cv
cv
cv
cv
cv
cv
cv
cv
cv
cv
cv
cv
cv
"}
(16,1,1) = {"
cv
cv
cv
cv
cv
cv
cv
cv
cv
cv
cv
cv
cv
cv
cv
cv
cv
cv
cv
cv
cv
cv
cv
cv
cv
cv
cv
cv
cv
cv
cv
cv
cv
cv
cv
cv
cv
cv
cv
cv
cv
cv
cv
cv
"}
(17,1,1) = {"
cv
cv
cv
cv
cv
cv
cv
cv
cv
cv
cv
cv
cv
cv
cv
cv
cv
cv
cv
cv
cv
cv
cv
cv
cv
cv
cv
cv
cv
cv
cv
cv
cv
cv
cv
cv
cv
cv
cv
cv
cv
cv
cv
cv
"}
(18,1,1) = {"
cv
cv
cv
cv
cv
cv
cv
cv
cv
cv
cv
cv
cv
cv
cv
cv
cv
cv
cv
cv
cv
cv
cv
cv
cv
cv
cv
cv
cv
cv
cv
cv
cv
cv
cv
cv
cv
cv
cv
cv
cv
cv
cv
cv
"}
(19,1,1) = {"
cv
cv
cv
cv
cv
cv
cv
cv
cv
cv
cv
cv
cv
cv
cv
cv
cv
cv
cv
cv
cv
cv
cv
cv
cv
cv
cv
cv
cv
cv
cv
cv
cv
cv
cv
cv
cv
cv
cv
cv
cv
cv
cv
cv
"}
(20,1,1) = {"
cv
cv
cv
cv
cv
cv
cv
cv
cv
cv
cv
cv
Mo
Mo
Mo
Mo
Mo
Mo
Mo
cv
cv
cv
cv
cv
cv
cv
cv
cv
cv
cv
cv
cv
cv
cv
cv
cv
cv
cv
cv
cv
cv
cv
cv
cv
"}
(21,1,1) = {"
cv
cv
cv
cv
cv
cv
cv
cv
cv
cv
cv
cv
es
es
es
es
es
es
Mo
Mo
Mo
jv
Mo
Mo
Mo
Mo
cv
cv
cv
cv
cv
cv
cv
cv
cv
cv
cv
cv
cv
cv
cv
cv
cv
cv
"}
(22,1,1) = {"
cv
cv
cv
cv
cv
cv
cv
cv
cv
cv
cv
cv
es
es
es
es
es
es
Mo
es
es
es
es
sy
xx
xx
Mo
cv
cv
cv
cv
cv
cv
cv
cv
cv
cv
cv
cv
cv
cv
cv
cv
cv
"}
(23,1,1) = {"
cv
cv
cv
cv
cv
cv
cv
cv
cv
cv
cv
cv
es
es
es
es
es
es
em
es
zz
es
es
Dl
QM
xx
Mo
cv
cv
cv
cv
cv
cv
cv
cv
cv
cv
cv
cv
cv
cv
cv
cv
cv
"}
(24,1,1) = {"
cv
cv
cv
cv
cv
cv
cv
cv
cv
cv
cv
cv
es
es
es
es
es
es
jv
es
es
CS
es
sy
xx
QM
jv
cv
cv
cv
cv
cv
cv
cv
cv
cv
cv
cv
cv
cv
cv
cv
cv
cv
"}
(25,1,1) = {"
cv
cv
cv
cv
cv
cv
cv
cv
cv
cv
cv
cv
es
es
es
es
es
es
Mo
es
es
Bt
es
es
mG
mG
Mo
cv
cv
cv
cv
cv
cv
cv
cv
cv
cv
cv
cv
cv
cv
cv
cv
cv
"}
(26,1,1) = {"
cv
cv
cv
cv
cv
cv
cv
cv
cv
cv
cv
cv
Mo
Mo
Mo
Mo
Mo
jv
Mo
es
es
es
es
xm
es
es
Mo
cv
cv
cv
cv
cv
cv
cv
cv
cv
cv
cv
cv
cv
cv
cv
cv
cv
"}
(27,1,1) = {"
cv
cv
cv
cv
cv
cv
cv
cv
mi
mi
fQ
fQ
Mo
Mo
Mo
cv
cv
cv
Mo
Qq
Qq
es
es
es
Qq
Qq
Mo
cv
cv
cv
cv
cv
cv
cv
cv
cv
cv
cv
cv
cv
cv
cv
cv
cv
"}
(28,1,1) = {"
cv
cv
cv
cv
cv
cv
cv
cv
mi
cv
cv
as
as
as
Mo
cv
cv
cv
Mo
Xn
xx
vM
es
sy
xx
xx
Mo
cv
cv
cv
cv
cv
cv
cv
cv
cv
cv
cv
cv
cv
cv
cv
cv
cv
"}
(29,1,1) = {"
cv
cv
cv
cv
cv
cv
cv
cv
mi
cv
cv
as
as
as
Mo
cv
cv
cv
Mo
Oh
xx
eu
es
Dl
xx
xx
Mo
cv
cv
cv
cv
cv
cv
cv
cv
cv
cv
cv
cv
cv
cv
cv
cv
cv
"}
(30,1,1) = {"
cv
cv
cv
cv
cv
cv
cv
cv
fQ
as
as
Mq
Jm
as
Mo
Mo
Mo
Mo
jv
xx
mH
vM
es
sy
xx
Mn
Mo
cv
cv
cv
cv
cv
cv
cv
cv
cv
cv
cv
cv
cv
cv
cv
cv
cv
"}
(31,1,1) = {"
cv
cv
cv
cv
cv
cv
cv
cv
gG
as
as
as
as
as
Mo
Ot
hY
Mo
Mo
Mo
Mo
jv
cU
Mo
Mo
Mo
Mo
Mo
cv
cv
cv
cv
cv
cv
cv
cv
cv
cv
cv
cv
cv
cv
cv
cv
"}
(32,1,1) = {"
cv
cv
cv
cv
cv
cv
cv
cv
Mo
Tq
Kv
MO
Kv
YQ
Mo
as
HS
Mo
WO
oC
OL
es
es
es
Py
SQ
GX
Mo
Mo
JF
JF
JF
JF
JF
Mo
Mo
cv
cv
cv
cv
cv
cv
cv
cv
"}
(33,1,1) = {"
cv
cv
cv
cv
cv
cv
cv
cv
Mo
Mo
as
Fy
as
Mo
As
Mo
Fy
Mo
zy
es
es
es
es
es
es
VT
gw
Mo
xx
gl
xx
gl
xx
vE
gl
Mo
cv
cv
cv
cv
cv
cv
cv
cv
"}
(34,1,1) = {"
cv
cv
cv
cv
Mo
Mo
Mo
Mo
Mo
as
as
uq
eh
eh
eh
xt
UE
Mo
GT
es
iP
iP
iP
iP
iP
es
zc
jv
gl
xx
vE
gl
xx
xx
Fa
Mo
Mo
Mo
cv
cv
cv
cv
cv
cv
"}
(35,1,1) = {"
cv
cv
cv
cv
Mo
Zl
as
mJ
Mo
as
as
as
as
as
as
Jm
Fy
AQ
es
es
iP
uJ
hb
tu
iP
du
Kj
zl
mG
mG
mG
eC
mG
mG
Pd
Mo
Mo
oG
cv
cv
cv
cv
cv
cv
"}
(36,1,1) = {"
cv
cv
cv
cv
Mo
wo
as
as
Io
as
as
as
as
as
as
as
Fy
GO
es
es
iP
Su
PS
uJ
iP
es
es
em
es
es
es
df
es
es
ZD
es
es
es
cv
cv
cv
cv
cv
cv
"}
(37,1,1) = {"
cv
cv
cv
cv
Mo
as
as
us
Mo
as
as
as
Jm
as
as
as
Fy
Pn
es
Ei
iP
hb
uJ
Vk
iP
es
es
zl
Qq
OE
Qq
Qq
Qq
Qq
Qq
Mo
Mo
Mo
cv
cv
cv
cv
cv
cv
"}
(38,1,1) = {"
cv
cv
cv
cv
Mo
Mo
Mo
Mo
Mo
as
as
gp
eh
eh
eh
eh
hW
Mo
do
es
iP
iP
iP
iP
Vb
es
Je
Mo
xx
xx
xx
gl
xx
xx
vE
Mo
Mo
Mo
cv
cv
cv
cv
cv
cv
"}
(39,1,1) = {"
cv
cv
cv
cv
cv
cv
Mo
Mo
Mo
zV
as
Fy
as
Mo
As
Mo
Mo
jv
do
es
es
es
es
es
es
es
gw
jv
gl
xx
vE
xx
xx
xx
xx
Mo
cv
cv
cv
cv
cv
cv
cv
cv
"}
(40,1,1) = {"
cv
cv
cv
cv
cv
cv
Mo
wG
jA
Kv
Kv
Hw
Kv
Kv
jA
qo
Mo
Mo
rW
La
nV
es
es
es
Hf
Yr
Cd
Mo
Mo
JF
JF
JF
JF
JF
Mo
Mo
cv
cv
cv
cv
cv
cv
cv
cv
"}
(41,1,1) = {"
cv
cv
cv
cv
cv
cv
Mo
Mo
DT
Jm
as
as
as
as
DT
Mo
Mo
Mo
Mo
Mo
Mo
jv
em
Hu
Mo
sO
Mo
Mo
cv
cv
cv
cv
cv
cv
cv
cv
cv
cv
cv
cv
cv
cv
cv
cv
"}
(42,1,1) = {"
cv
cv
cv
cv
cv
cv
cv
cv
Mo
as
as
as
as
as
Mo
cv
cv
cv
Mo
es
es
es
es
es
es
es
Mo
cv
cv
cv
cv
cv
cv
cv
cv
cv
cv
cv
cv
cv
cv
cv
cv
cv
"}
(43,1,1) = {"
cv
cv
cv
cv
cv
cv
cv
cv
Mo
as
QL
as
PL
as
Mo
cv
cv
cv
Mo
es
Ec
es
es
es
ez
es
jv
cv
cv
cv
cv
cv
cv
cv
cv
cv
cv
cv
cv
cv
cv
cv
cv
cv
"}
(44,1,1) = {"
cv
cv
cv
cv
cv
cv
cv
cv
Mo
as
as
as
as
as
Mo
cv
cv
cv
Mo
xx
xx
xx
es
es
es
es
Mo
cv
cv
cv
cv
cv
cv
cv
cv
cv
cv
cv
cv
cv
cv
cv
cv
cv
"}
(45,1,1) = {"
cv
cv
cv
cv
cv
cv
cv
cv
Mo
Mo
Mo
Mo
Mo
Mo
Mo
cv
cv
cv
JF
Ec
es
es
kE
es
es
ez
JF
cv
cv
cv
cv
cv
cv
cv
cv
cv
cv
cv
cv
cv
cv
cv
cv
cv
"}
(46,1,1) = {"
cv
cv
cv
cv
cv
cv
cv
cv
cv
cv
cv
cv
cv
cv
cv
cv
cv
cv
JF
tN
es
pI
NW
SD
es
es
JF
cv
cv
cv
cv
cv
cv
cv
cv
cv
cv
cv
cv
cv
cv
cv
cv
cv
"}
(47,1,1) = {"
cv
cv
cv
cv
cv
cv
cv
cv
cv
cv
cv
cv
cv
cv
cv
cv
cv
cv
JF
ez
es
es
OF
es
xx
Ec
JF
cv
cv
cv
cv
cv
cv
cv
cv
cv
cv
cv
cv
cv
cv
cv
cv
cv
"}
(48,1,1) = {"
cv
cv
cv
cv
cv
cv
cv
cv
cv
cv
cv
cv
cv
cv
cv
cv
cv
cv
jv
es
es
es
es
es
es
xx
Mo
cv
cv
cv
cv
cv
cv
cv
cv
cv
cv
cv
cv
cv
cv
cv
cv
cv
"}
(49,1,1) = {"
cv
cv
cv
cv
cv
cv
cv
cv
cv
cv
cv
cv
cv
cv
cv
cv
cv
cv
Mo
es
ez
es
es
es
ez
es
jv
cv
cv
cv
cv
cv
cv
cv
cv
cv
cv
cv
cv
cv
cv
cv
cv
cv
"}
(50,1,1) = {"
cv
cv
cv
cv
cv
cv
cv
cv
cv
cv
cv
cv
cv
cv
cv
cv
cv
cv
Mo
es
es
RX
iL
Fi
es
es
Mo
cv
cv
cv
cv
cv
cv
cv
cv
cv
cv
cv
cv
cv
cv
cv
cv
cv
"}
(51,1,1) = {"
cv
cv
cv
cv
cv
cv
cv
cv
cv
cv
cv
cv
cv
cv
cv
cv
cv
cv
cv
Mo
JF
JF
JF
JF
JF
Mo
cv
cv
cv
cv
cv
cv
cv
cv
cv
cv
cv
cv
cv
cv
cv
cv
cv
cv
"}
(52,1,1) = {"
cv
cv
cv
cv
cv
cv
cv
cv
cv
cv
cv
cv
cv
cv
cv
cv
cv
cv
cv
cv
cv
cv
cv
cv
cv
cv
cv
cv
cv
cv
cv
cv
cv
cv
cv
cv
cv
cv
cv
cv
cv
cv
cv
cv
"}
(53,1,1) = {"
cv
cv
cv
cv
cv
cv
cv
cv
cv
cv
cv
cv
cv
cv
cv
cv
cv
cv
cv
cv
cv
cv
cv
cv
cv
cv
cv
cv
cv
cv
cv
cv
cv
cv
cv
cv
cv
cv
cv
cv
cv
cv
cv
cv
"}
(54,1,1) = {"
cv
cv
cv
cv
cv
cv
cv
cv
cv
cv
cv
cv
cv
cv
cv
cv
cv
cv
cv
cv
cv
cv
cv
cv
cv
cv
cv
cv
cv
cv
cv
cv
cv
cv
cv
cv
cv
cv
cv
cv
cv
cv
cv
cv
"}
(55,1,1) = {"
cv
cv
cv
cv
cv
cv
cv
cv
cv
cv
cv
cv
cv
cv
cv
cv
cv
cv
cv
cv
cv
cv
cv
cv
cv
cv
cv
cv
cv
cv
cv
cv
cv
cv
cv
cv
cv
cv
cv
cv
cv
cv
cv
cv
"}
(56,1,1) = {"
cv
cv
cv
cv
cv
cv
cv
cv
cv
cv
cv
cv
cv
cv
cv
cv
cv
cv
cv
cv
cv
cv
cv
cv
cv
cv
cv
cv
cv
cv
cv
cv
cv
cv
cv
cv
cv
cv
cv
cv
cv
cv
cv
cv
"}
(57,1,1) = {"
cv
cv
cv
cv
cv
cv
cv
cv
cv
cv
cv
cv
cv
cv
cv
cv
cv
cv
cv
cv
cv
cv
cv
cv
cv
cv
cv
cv
cv
cv
cv
cv
cv
cv
cv
cv
cv
cv
cv
cv
cv
cv
cv
cv
"}
(58,1,1) = {"
cv
cv
cv
cv
cv
cv
cv
cv
cv
cv
cv
cv
cv
cv
cv
cv
cv
cv
cv
cv
cv
cv
cv
cv
cv
cv
cv
cv
cv
cv
cv
cv
cv
cv
cv
cv
cv
cv
cv
cv
cv
cv
cv
cv
"}
(59,1,1) = {"
cv
cv
cv
cv
cv
cv
cv
cv
cv
cv
cv
cv
cv
cv
cv
cv
cv
cv
cv
cv
cv
cv
cv
cv
cv
cv
cv
cv
cv
cv
cv
cv
cv
cv
cv
cv
cv
cv
cv
cv
cv
cv
cv
cv
"}
(60,1,1) = {"
cv
cv
cv
cv
cv
cv
cv
cv
cv
cv
cv
cv
cv
cv
cv
cv
cv
cv
cv
cv
cv
cv
cv
cv
cv
cv
cv
cv
cv
cv
cv
cv
cv
cv
cv
cv
cv
cv
cv
cv
cv
cv
cv
cv
"}
