//MAP CONVERTED BY dmm2tgm.py THIS HEADER COMMENT PREVENTS RECONVERSION, DO NOT REMOVE
"a" = (
/turf/simulated/floor/transparent/glass/reinforced,
/area/space)
"b" = (
/obj/structure/table/wood,
/obj/item/book/manual/random,
/turf/simulated/floor/wood,
/area/space)
"h" = (
/obj/structure/table/wood,
/turf/simulated/floor/wood,
/area/space)
"i" = (
/obj/structure/table/wood,
/obj/item/candle/eternal{
	lit = 1;
	start_lit = 1
	},
/turf/simulated/floor/wood,
/area/space)
"j" = (
/obj/structure/table/wood/fancy,
/obj/item/stack/sheet/cardboard,
/obj/item/pen/multi/fountain,
/turf/simulated/floor/wood,
/area/space)
"k" = (
/obj/structure/table/wood/fancy,
/turf/simulated/floor/wood,
/area/space)
"l" = (
/obj/structure/chair/comfy/black{
	dir = 1
	},
/turf/simulated/floor/wood,
/area/space)
"r" = (
/obj/structure/bookcase/random,
/turf/simulated/floor/wood,
/area/space)
"t" = (
/obj/structure/table/wood,
/obj/item/flashlight/lamp/green{
	pixel_x = 1;
	pixel_y = 5
	},
/turf/simulated/floor/wood,
/area/space)
"u" = (
/obj/structure/bookcase,
/turf/simulated/floor/wood,
/area/space)
"y" = (
/obj/structure/bookcase/manuals/research_and_development,
/turf/simulated/floor/wood,
/area/space)
"A" = (
/obj/structure/table/wood/fancy,
/obj/item/folder/yellow,
/turf/simulated/floor/wood,
/area/space)
"B" = (
/obj/structure/chair/comfy/black{
	dir = 4
	},
/turf/simulated/floor/wood,
/area/space)
"D" = (
/turf/simulated/wall,
/area/space)
"E" = (
/obj/structure/table/wood,
/obj/item/book/manual/zombie_manual,
/turf/simulated/floor/wood,
/area/space)
"G" = (
/obj/machinery/door/window/classic/reversed{
	dir = 8;
	name = "Library Desk Door"
	},
/turf/simulated/floor/wood,
/area/space)
"H" = (
/obj/effect/spawner/random_spawners/cobweb_right_frequent,
/turf/simulated/floor/wood,
/area/space)
"I" = (
/turf/space,
/area/space)
"J" = (
/obj/structure/table/wood/fancy,
/obj/item/storage/box/characters,
/turf/simulated/floor/wood,
/area/space)
"M" = (
/obj/structure/chair/wood/wings{
	dir = 4
	},
/turf/simulated/floor/wood,
/area/space)
"P" = (
/obj/machinery/photocopier,
/turf/simulated/floor/wood,
/area/space)
"S" = (
/turf/simulated/floor/wood,
/area/space)
"U" = (
/obj/structure/chair/wood/wings{
	dir = 8
	},
/turf/simulated/floor/wood,
/area/space)
"V" = (
/obj/effect/spawner/random_spawners/cobweb_left_frequent,
/turf/simulated/floor/wood,
/area/space)
"Y" = (
/obj/structure/chair/comfy/red,
/turf/simulated/floor/wood,
/area/space)
"Z" = (
/obj/structure/chair/comfy/black{
	dir = 8
	},
/turf/simulated/floor/wood,
/area/space)

(1,1,1) = {"
I
I
I
I
I
I
I
I
I
I
I
I
I
I
I
I
I
I
I
I
I
I
I
I
I
I
I
I
I
I
I
I
I
I
I
I
I
I
I
I
I
I
I
I
I
I
I
I
I
I
"}
(2,1,1) = {"
I
I
I
I
I
I
I
I
I
I
I
I
I
I
I
I
I
I
I
I
I
I
I
I
I
I
I
I
I
I
I
I
I
I
I
I
I
I
I
I
I
I
I
I
I
I
I
I
I
I
"}
(3,1,1) = {"
I
I
I
I
I
I
I
I
I
I
I
I
I
I
I
I
I
I
I
I
I
I
I
I
I
I
I
I
I
I
I
I
I
I
I
I
I
I
I
I
I
I
I
I
I
I
I
I
I
I
"}
(4,1,1) = {"
I
I
I
I
I
I
I
I
I
I
I
I
I
I
I
I
I
I
I
I
I
I
I
I
I
I
I
I
I
I
I
I
I
I
I
I
I
I
I
I
I
I
I
I
I
I
I
I
I
I
"}
(5,1,1) = {"
I
I
I
I
I
I
I
I
I
I
I
I
I
I
I
I
I
I
I
I
I
I
I
I
I
I
I
I
I
I
I
I
I
I
I
I
I
I
I
I
I
I
I
I
I
I
I
I
I
I
"}
(6,1,1) = {"
I
I
I
I
I
I
I
I
I
I
I
I
I
I
I
I
I
I
I
I
I
I
I
I
I
I
I
I
I
I
I
I
I
I
I
I
I
I
I
I
I
I
I
I
I
I
I
I
I
I
"}
(7,1,1) = {"
I
I
I
I
I
I
I
I
I
I
I
I
I
I
I
I
I
I
I
I
I
I
I
I
I
I
I
I
I
I
I
I
I
I
I
I
I
I
I
I
I
I
I
I
I
I
I
I
I
I
"}
(8,1,1) = {"
I
I
I
I
I
I
I
I
I
I
I
I
I
I
I
I
I
I
I
I
I
I
I
I
I
I
I
I
I
I
I
I
I
I
I
I
I
I
I
I
I
I
I
I
I
I
I
I
I
I
"}
(9,1,1) = {"
I
I
I
I
I
I
I
I
I
I
I
I
I
I
I
I
I
I
I
I
I
I
I
I
I
I
I
I
I
I
I
I
I
I
I
I
I
I
I
I
I
I
I
I
I
I
I
I
I
I
"}
(10,1,1) = {"
I
I
I
I
I
I
I
I
I
I
I
I
I
I
I
I
I
I
I
I
I
I
I
I
I
I
I
I
I
I
I
I
I
I
I
I
I
I
I
I
I
I
I
I
I
I
I
I
I
I
"}
(11,1,1) = {"
I
I
I
I
I
I
I
I
I
I
I
I
I
I
I
I
I
I
I
I
I
I
I
I
I
I
I
I
I
I
I
I
I
I
I
I
I
I
I
I
I
I
I
I
I
I
I
I
I
I
"}
(12,1,1) = {"
I
I
I
I
I
I
I
I
I
I
I
I
I
I
I
I
I
I
D
D
D
D
D
D
D
D
D
D
D
D
D
I
I
I
I
I
I
I
I
I
I
I
I
I
I
I
I
I
I
I
"}
(13,1,1) = {"
I
I
I
I
I
I
I
I
I
I
I
I
I
I
I
I
I
D
V
M
S
M
S
r
V
y
S
r
S
S
S
D
I
I
I
I
I
I
I
I
I
I
I
I
I
I
I
I
I
I
"}
(14,1,1) = {"
I
I
I
I
I
I
I
I
I
I
I
I
I
I
I
I
I
D
S
b
S
t
S
u
S
u
S
r
S
S
S
D
I
I
I
I
I
I
I
I
I
I
I
I
I
I
I
I
I
I
"}
(15,1,1) = {"
I
I
I
I
I
I
I
I
I
I
I
I
I
I
I
I
I
D
S
U
S
U
S
y
S
r
S
r
S
S
S
D
I
I
I
I
I
I
I
I
I
I
I
I
I
I
I
I
I
I
"}
(16,1,1) = {"
I
I
I
I
I
I
I
I
I
I
I
I
I
I
I
I
I
D
S
M
S
M
S
S
S
S
S
S
S
P
S
D
I
I
I
I
I
I
I
I
I
I
I
I
I
I
I
I
I
I
"}
(17,1,1) = {"
I
I
I
I
I
I
I
I
I
I
I
I
I
I
I
I
I
D
S
E
S
i
a
a
a
a
a
a
a
a
I
I
I
I
I
I
I
I
I
I
I
I
I
I
I
I
I
I
I
I
"}
(18,1,1) = {"
I
I
I
I
I
I
I
I
I
I
I
I
I
I
I
I
I
D
S
U
S
U
a
a
a
a
a
a
a
a
I
I
I
I
I
I
I
I
I
I
I
I
I
I
I
I
I
I
I
I
"}
(19,1,1) = {"
I
I
I
I
I
I
I
I
I
I
I
I
I
I
I
I
I
D
S
S
S
S
a
a
a
a
a
a
a
a
I
I
I
I
I
I
I
I
I
I
I
I
I
I
I
I
I
I
I
I
"}
(20,1,1) = {"
I
I
I
I
I
I
I
I
I
I
I
I
I
I
I
I
I
D
S
S
S
S
a
a
a
S
S
B
B
S
I
I
I
I
I
I
I
I
I
I
I
I
I
I
I
I
I
I
I
I
"}
(21,1,1) = {"
I
I
I
I
I
I
I
I
I
I
I
I
I
I
I
I
I
I
G
h
h
S
a
a
a
S
k
A
A
l
I
I
I
I
I
I
I
I
I
I
I
I
I
I
I
I
I
I
I
I
"}
(22,1,1) = {"
I
I
I
I
I
I
I
I
I
I
I
I
I
I
I
I
I
I
S
S
i
S
a
a
a
Y
j
k
A
l
I
I
I
I
I
I
I
I
I
I
I
I
I
I
I
I
I
I
I
I
"}
(23,1,1) = {"
I
I
I
I
I
I
I
I
I
I
I
I
I
I
I
I
I
I
S
S
h
S
a
a
a
S
J
A
k
l
I
I
I
I
I
I
I
I
I
I
I
I
I
I
I
I
I
I
I
I
"}
(24,1,1) = {"
I
I
I
I
I
I
I
I
I
I
I
I
I
I
I
I
I
I
S
S
h
S
a
a
a
H
S
Z
Z
S
I
I
I
I
I
I
I
I
I
I
I
I
I
I
I
I
I
I
I
I
"}
(25,1,1) = {"
I
I
I
I
I
I
I
I
I
I
I
I
I
I
I
I
I
I
I
I
I
I
I
I
I
I
I
I
I
I
I
I
I
I
I
I
I
I
I
I
I
I
I
I
I
I
I
I
I
I
"}
(26,1,1) = {"
I
I
I
I
I
I
I
I
I
I
I
I
I
I
I
I
I
I
I
I
I
I
I
I
I
I
I
I
I
I
I
I
I
I
I
I
I
I
I
I
I
I
I
I
I
I
I
I
I
I
"}
(27,1,1) = {"
I
I
I
I
I
I
I
I
I
I
I
I
I
I
I
I
I
I
I
I
I
I
I
I
I
I
I
I
I
I
I
I
I
I
I
I
I
I
I
I
I
I
I
I
I
I
I
I
I
I
"}
(28,1,1) = {"
I
I
I
I
I
I
I
I
I
I
I
I
I
I
I
I
I
I
I
I
I
I
I
I
I
I
I
I
I
I
I
I
I
I
I
I
I
I
I
I
I
I
I
I
I
I
I
I
I
I
"}
(29,1,1) = {"
I
I
I
I
I
I
I
I
I
I
I
I
I
I
I
I
I
I
I
I
I
I
I
I
I
I
I
I
I
I
I
I
I
I
I
I
I
I
I
I
I
I
I
I
I
I
I
I
I
I
"}
(30,1,1) = {"
I
I
I
I
I
I
I
I
I
I
I
I
I
I
I
I
I
I
I
I
I
I
I
I
I
I
I
I
I
I
I
I
I
I
I
I
I
I
I
I
I
I
I
I
I
I
I
I
I
I
"}
(31,1,1) = {"
I
I
I
I
I
I
I
I
I
I
I
I
I
I
I
I
I
I
I
I
I
I
I
I
I
I
I
I
I
I
I
I
I
I
I
I
I
I
I
I
I
I
I
I
I
I
I
I
I
I
"}
(32,1,1) = {"
I
I
I
I
I
I
I
I
I
I
I
I
I
I
I
I
I
I
I
I
I
I
I
I
I
I
I
I
I
I
I
I
I
I
I
I
I
I
I
I
I
I
I
I
I
I
I
I
I
I
"}
(33,1,1) = {"
I
I
I
I
I
I
I
I
I
I
I
I
I
I
I
I
I
I
I
I
I
I
I
I
I
I
I
I
I
I
I
I
I
I
I
I
I
I
I
I
I
I
I
I
I
I
I
I
I
I
"}
(34,1,1) = {"
I
I
I
I
I
I
I
I
I
I
I
I
I
I
I
I
I
I
I
I
I
I
I
I
I
I
I
I
I
I
I
I
I
I
I
I
I
I
I
I
I
I
I
I
I
I
I
I
I
I
"}
(35,1,1) = {"
I
I
I
I
I
I
I
I
I
I
I
I
I
I
I
I
I
I
I
I
I
I
I
I
I
I
I
I
I
I
I
I
I
I
I
I
I
I
I
I
I
I
I
I
I
I
I
I
I
I
"}
(36,1,1) = {"
I
I
I
I
I
I
I
I
I
I
I
I
I
I
I
I
I
I
I
I
I
I
I
I
I
I
I
I
I
I
I
I
I
I
I
I
I
I
I
I
I
I
I
I
I
I
I
I
I
I
"}
(37,1,1) = {"
I
I
I
I
I
I
I
I
I
I
I
I
I
I
I
I
I
I
I
I
I
I
I
I
I
I
I
I
I
I
I
I
I
I
I
I
I
I
I
I
I
I
I
I
I
I
I
I
I
I
"}
(38,1,1) = {"
I
I
I
I
I
I
I
I
I
I
I
I
I
I
I
I
I
I
I
I
I
I
I
I
I
I
I
I
I
I
I
I
I
I
I
I
I
I
I
I
I
I
I
I
I
I
I
I
I
I
"}
(39,1,1) = {"
I
I
I
I
I
I
I
I
I
I
I
I
I
I
I
I
I
I
I
I
I
I
I
I
I
I
I
I
I
I
I
I
I
I
I
I
I
I
I
I
I
I
I
I
I
I
I
I
I
I
"}
(40,1,1) = {"
I
I
I
I
I
I
I
I
I
I
I
I
I
I
I
I
I
I
I
I
I
I
I
I
I
I
I
I
I
I
I
I
I
I
I
I
I
I
I
I
I
I
I
I
I
I
I
I
I
I
"}
(41,1,1) = {"
I
I
I
I
I
I
I
I
I
I
I
I
I
I
I
I
I
I
I
I
I
I
I
I
I
I
I
I
I
I
I
I
I
I
I
I
I
I
I
I
I
I
I
I
I
I
I
I
I
I
"}
(42,1,1) = {"
I
I
I
I
I
I
I
I
I
I
I
I
I
I
I
I
I
I
I
I
I
I
I
I
I
I
I
I
I
I
I
I
I
I
I
I
I
I
I
I
I
I
I
I
I
I
I
I
I
I
"}
(43,1,1) = {"
I
I
I
I
I
I
I
I
I
I
I
I
I
I
I
I
I
I
I
I
I
I
I
I
I
I
I
I
I
I
I
I
I
I
I
I
I
I
I
I
I
I
I
I
I
I
I
I
I
I
"}
(44,1,1) = {"
I
I
I
I
I
I
I
I
I
I
I
I
I
I
I
I
I
I
I
I
I
I
I
I
I
I
I
I
I
I
I
I
I
I
I
I
I
I
I
I
I
I
I
I
I
I
I
I
I
I
"}
(45,1,1) = {"
I
I
I
I
I
I
I
I
I
I
I
I
I
I
I
I
I
I
I
I
I
I
I
I
I
I
I
I
I
I
I
I
I
I
I
I
I
I
I
I
I
I
I
I
I
I
I
I
I
I
"}
(46,1,1) = {"
I
I
I
I
I
I
I
I
I
I
I
I
I
I
I
I
I
I
I
I
I
I
I
I
I
I
I
I
I
I
I
I
I
I
I
I
I
I
I
I
I
I
I
I
I
I
I
I
I
I
"}
(47,1,1) = {"
I
I
I
I
I
I
I
I
I
I
I
I
I
I
I
I
I
I
I
I
I
I
I
I
I
I
I
I
I
I
I
I
I
I
I
I
I
I
I
I
I
I
I
I
I
I
I
I
I
I
"}
(48,1,1) = {"
I
I
I
I
I
I
I
I
I
I
I
I
I
I
I
I
I
I
I
I
I
I
I
I
I
I
I
I
I
I
I
I
I
I
I
I
I
I
I
I
I
I
I
I
I
I
I
I
I
I
"}
(49,1,1) = {"
I
I
I
I
I
I
I
I
I
I
I
I
I
I
I
I
I
I
I
I
I
I
I
I
I
I
I
I
I
I
I
I
I
I
I
I
I
I
I
I
I
I
I
I
I
I
I
I
I
I
"}
(50,1,1) = {"
I
I
I
I
I
I
I
I
I
I
I
I
I
I
I
I
I
I
I
I
I
I
I
I
I
I
I
I
I
I
I
I
I
I
I
I
I
I
I
I
I
I
I
I
I
I
I
I
I
I
"}
