//MAP CONVERTED BY dmm2tgm.py THIS HEADER COMMENT PREVENTS RECONVERSION, DO NOT REMOVE
"a" = (
/turf/space,
/area/space)
"b" = (
/obj/effect/spawner/random/dirt/often,
/turf/simulated/floor/plating,
/area/space)
"d" = (
/obj/structure/extinguisher_cabinet{
	name = "north bump";
	pixel_y = 30
	},
/turf/simulated/floor/mineral/titanium,
/area/space)
"e" = (
/turf/simulated/floor/mineral/plastitanium,
/area/space)
"f" = (
/obj/machinery/door/airlock/multi_tile/glass/directional/north,
/turf/simulated/floor/mineral/plastitanium,
/area/space)
"g" = (
/obj/machinery/door/airlock/titanium/glass,
/turf/simulated/floor/mineral/titanium,
/area/space)
"h" = (
/obj/effect/spawner/window/shuttle,
/turf/simulated/floor/plating,
/area/space)
"i" = (
/obj/item/gps/ruin{
	gpstag = "NT Medical Ship";
	pixel_x = -32
	},
/turf/simulated/floor/plating,
/area/space)
"k" = (
/obj/machinery/light/small,
/obj/machinery/atmospherics/unary/portables_connector{
	dir = 8
	},
/obj/machinery/atmospherics/portable/canister/air,
/turf/simulated/floor/plating,
/area/space)
"l" = (
/obj/effect/spawner/random/pool/whiteship_mob,
/turf/simulated/floor/mineral/titanium,
/area/space)
"m" = (
/turf/simulated/wall/mineral/titanium,
/area/space)
"p" = (
/obj/effect/spawner/random/dirt/often,
/obj/machinery/atmospherics/pipe/simple/hidden,
/turf/simulated/floor/mineral/titanium,
/area/space)
"q" = (
/turf/simulated/floor/plating,
/area/space)
"r" = (
/obj/structure/table/reinforced,
/obj/item/whiteship_port_generator,
/turf/simulated/floor/mineral/plastitanium,
/area/space)
"s" = (
/obj/machinery/light/small{
	dir = 4
	},
/obj/item/salvage/ruin/pirate,
/turf/simulated/floor/mineral/titanium,
/area/space)
"u" = (
/obj/effect/map_effect/marker/mapmanip/submap/insert/space_ruin/white_ship/storage,
/turf/simulated/floor/plating,
/area/space)
"v" = (
/obj/structure/table,
/obj/item/storage/box/lights/mixed,
/obj/item/stock_parts/cell{
	charge = 100;
	maxcharge = 15000;
	pixel_x = -3;
	pixel_y = -3
	},
/turf/simulated/floor/plating,
/area/space)
"w" = (
/turf/simulated/floor/wood,
/area/space)
"x" = (
/turf/simulated/floor/mineral/titanium/blue,
/area/space)
"y" = (
/obj/effect/spawner/random/dirt/often,
/obj/machinery/door/airlock/titanium,
/obj/machinery/atmospherics/pipe/simple/hidden,
/turf/simulated/floor/plating,
/area/space)
"z" = (
/obj/structure/table/reinforced,
/obj/item/analyzer,
/turf/simulated/floor/mineral/plastitanium,
/area/space)
"A" = (
/obj/machinery/light/small{
	dir = 1
	},
/obj/effect/spawner/random/dirt/often,
/turf/simulated/floor/plating,
/area/space)
"B" = (
/obj/effect/map_effect/marker/mapmanip/submap/insert/space_ruin/white_ship/gun_room,
/turf/simulated/wall/mineral/titanium,
/area/space)
"C" = (
/obj/structure/sign/poster/official/random/directional/south,
/turf/simulated/floor/mineral/titanium,
/area/space)
"D" = (
/obj/structure/shuttle/engine/heater{
	dir = 4
	},
/obj/structure/window/reinforced{
	dir = 8
	},
/turf/simulated/floor/plating/airless,
/area/space)
"F" = (
/turf/simulated/floor/mineral/titanium,
/area/space)
"G" = (
/obj/structure/table,
/obj/item/radio{
	pixel_x = -6;
	pixel_y = 6
	},
/obj/item/radio{
	pixel_y = 4
	},
/obj/item/radio{
	pixel_x = 6;
	pixel_y = 6
	},
/turf/simulated/floor/mineral/titanium,
/area/space)
"H" = (
/turf/simulated/floor/plating/airless,
/area/space)
"I" = (
/obj/structure/shuttle/engine/propulsion{
	dir = 4;
	icon_state = "burst_r"
	},
/turf/simulated/floor/plating/airless,
/area/space)
"J" = (
/obj/machinery/computer/shuttle/white_ship{
	dir = 4
	},
/turf/simulated/floor/mineral/plastitanium,
/area/space)
"K" = (
/obj/structure/sign/vacuum/external{
	pixel_y = -32
	},
/obj/effect/spawner/random/dirt/often,
/turf/simulated/floor/plating,
/area/space)
"L" = (
/obj/structure/sign/poster/official/random/directional/north,
/turf/simulated/floor/mineral/titanium,
/area/space)
"M" = (
/obj/machinery/light/small,
/turf/simulated/floor/mineral/titanium,
/area/space)
"O" = (
/obj/structure/chair/comfy/shuttle{
	dir = 8
	},
/obj/effect/spawner/random/pool/whiteship_mob,
/turf/simulated/floor/mineral/plastitanium,
/area/space)
"P" = (
/obj/effect/spawner/random/oil/often,
/obj/machinery/atmospherics/pipe/simple/hidden{
	dir = 6
	},
/obj/effect/spawner/random/pool/whiteship_mob,
/turf/simulated/floor/plating,
/area/space)
"Q" = (
/obj/structure/closet/crate,
/obj/item/flashlight/flare,
/obj/item/flashlight/flare,
/obj/item/flashlight/flare,
/obj/item/flashlight/flare/glowstick/blue,
/obj/item/flashlight/flare/glowstick/blue,
/obj/item/flashlight/flare/glowstick/blue,
/turf/simulated/floor/mineral/titanium,
/area/space)
"R" = (
/obj/structure/table,
/obj/item/storage/toolbox/mechanical,
/obj/item/multitool{
	pixel_x = -6
	},
/turf/simulated/floor/plating,
/area/space)
"S" = (
/obj/machinery/computer/nonfunctional{
	dir = 4
	},
/turf/simulated/floor/mineral/plastitanium,
/area/space)
"T" = (
/obj/structure/chair/comfy/shuttle{
	dir = 8
	},
/turf/simulated/floor/mineral/plastitanium,
/area/space)
"U" = (
/obj/effect/spawner/airlock/w_to_e/long/square,
/turf/simulated/wall/mineral/titanium,
/area/space)
"V" = (
/obj/machinery/light{
	dir = 4
	},
/obj/structure/chair/comfy/shuttle{
	dir = 8
	},
/turf/simulated/floor/mineral/plastitanium,
/area/space)
"W" = (
/obj/docking_port/stationary/whiteship{
	dir = 8;
	id = "whiteship_away";
	name = "Deep Space"
	},
/obj/docking_port/mobile/whiteship,
/turf/simulated/floor/plating,
/area/space)
"X" = (
/obj/machinery/light/small{
	dir = 1
	},
/turf/simulated/floor/mineral/titanium,
/area/space)
"Y" = (
/obj/effect/spawner/random/dirt/often,
/obj/machinery/atmospherics/pipe/simple/hidden{
	dir = 5
	},
/turf/simulated/floor/mineral/titanium,
/area/space)
"Z" = (
/turf/simulated/wall/mineral/titanium/nodiagonal,
/area/space)

(1,1,1) = {"
a
a
a
a
a
a
a
a
a
a
a
a
a
a
a
a
a
a
a
a
a
a
a
a
a
a
a
a
a
a
a
a
a
a
a
a
a
a
a
a
a
a
a
a
a
a
a
a
a
a
"}
(2,1,1) = {"
a
a
a
a
a
a
a
a
a
a
a
a
a
a
a
a
a
a
a
a
a
a
a
a
a
a
a
a
a
a
a
a
a
a
a
a
a
a
a
a
a
a
a
a
a
a
a
a
a
a
"}
(3,1,1) = {"
a
a
a
a
a
a
a
a
a
a
a
a
a
a
a
a
a
a
a
a
a
a
a
a
a
a
a
a
a
a
a
a
a
a
a
a
a
a
a
a
a
a
a
a
a
a
a
a
a
a
"}
(4,1,1) = {"
a
a
a
a
a
a
a
a
a
a
a
a
a
a
a
a
a
a
a
a
a
a
a
a
a
a
a
a
a
a
a
a
a
a
a
a
a
a
a
a
a
a
a
a
a
a
a
a
a
a
"}
(5,1,1) = {"
a
a
a
a
a
a
a
a
a
a
a
a
a
a
a
a
a
a
a
a
a
a
a
a
a
a
a
a
a
a
a
a
a
a
a
a
a
a
a
a
a
a
a
a
a
a
a
a
a
a
"}
(6,1,1) = {"
a
a
a
a
a
a
a
a
a
a
a
a
a
a
a
a
a
a
a
a
a
a
a
a
a
a
a
a
a
a
a
a
a
a
a
a
a
a
a
a
a
a
a
a
a
a
a
a
a
a
"}
(7,1,1) = {"
a
a
a
a
a
a
a
a
a
a
a
a
a
a
a
a
a
a
a
a
a
a
a
a
a
a
a
a
a
a
a
a
a
a
a
a
a
a
a
a
a
a
a
a
a
a
a
a
a
a
"}
(8,1,1) = {"
a
a
a
a
a
a
a
a
a
a
a
a
a
a
a
a
a
a
a
a
a
a
a
a
a
a
a
a
a
a
a
a
a
a
a
a
a
a
a
a
a
a
a
a
a
a
a
a
a
a
"}
(9,1,1) = {"
a
a
a
a
a
a
a
a
a
a
a
a
a
a
a
a
a
a
a
a
a
a
a
a
a
a
a
a
a
a
a
a
a
a
a
a
a
a
a
a
a
a
a
a
a
a
a
a
a
a
"}
(10,1,1) = {"
a
a
a
a
a
a
a
a
a
a
a
a
a
a
a
a
a
a
a
a
a
a
a
a
a
a
a
a
a
a
a
a
a
a
a
a
a
a
a
a
a
a
a
a
a
a
a
a
a
a
"}
(11,1,1) = {"
a
a
a
a
a
a
a
a
a
a
a
a
a
a
a
a
a
a
a
a
a
a
a
a
a
a
a
a
a
a
a
a
a
a
a
a
a
a
a
a
a
a
a
a
a
a
a
a
a
a
"}
(12,1,1) = {"
a
a
a
a
a
a
a
a
a
a
a
a
a
a
a
a
a
a
a
a
a
a
a
a
a
a
a
a
a
a
a
a
a
a
a
a
a
a
a
a
a
a
a
a
a
a
a
a
a
a
"}
(13,1,1) = {"
a
a
a
a
a
a
a
a
a
a
a
a
a
a
a
a
a
a
a
a
a
a
a
a
a
a
a
a
a
a
a
a
a
a
a
a
a
a
a
a
a
a
a
a
a
a
a
a
a
a
"}
(14,1,1) = {"
a
a
a
a
a
a
a
a
a
a
a
a
a
a
a
a
a
a
a
a
a
a
a
a
a
a
a
a
a
a
a
a
a
a
a
a
a
a
a
a
a
a
a
a
a
a
a
a
a
a
"}
(15,1,1) = {"
a
a
a
a
a
a
a
a
a
a
a
a
a
a
a
a
a
a
a
a
a
a
a
a
a
a
a
a
a
a
a
a
a
a
a
a
a
a
a
a
a
a
a
a
a
a
a
a
a
a
"}
(16,1,1) = {"
a
a
a
a
a
a
a
a
a
a
a
a
a
a
a
a
a
a
a
a
a
a
a
m
h
h
m
a
a
a
a
a
a
a
a
a
a
a
a
a
a
a
a
a
a
a
a
a
a
a
"}
(17,1,1) = {"
a
a
a
a
a
a
a
a
a
a
a
a
a
a
a
a
a
a
a
a
a
a
m
m
S
J
m
m
a
a
a
a
a
a
a
a
a
a
a
a
a
a
a
a
a
a
a
a
a
a
"}
(18,1,1) = {"
a
a
a
a
a
a
a
a
a
a
a
a
a
a
a
a
a
a
a
a
a
a
m
z
O
O
r
m
a
a
a
a
a
a
a
a
a
a
a
a
a
a
a
a
a
a
a
a
a
a
"}
(19,1,1) = {"
a
a
a
a
a
a
a
a
a
a
a
a
a
a
a
a
a
a
a
a
a
a
m
V
e
e
T
m
a
a
a
a
a
a
a
a
a
a
a
a
a
a
a
a
a
a
a
a
a
a
"}
(20,1,1) = {"
a
a
a
a
a
a
a
a
a
a
a
a
a
a
a
a
a
a
a
a
m
m
m
m
e
f
m
m
m
m
a
a
a
a
a
a
a
a
a
a
a
a
a
a
a
a
a
a
a
a
"}
(21,1,1) = {"
a
a
a
a
a
a
a
a
a
a
a
a
a
a
a
a
a
a
a
a
m
G
Q
m
X
F
m
x
x
m
a
a
a
a
a
a
a
a
a
a
a
a
a
a
a
a
a
a
a
a
"}
(22,1,1) = {"
a
a
a
a
a
a
a
a
a
a
a
a
a
a
a
a
a
a
a
a
m
s
l
g
F
F
m
x
x
m
a
a
a
a
a
a
a
a
a
a
a
a
a
a
a
a
a
a
a
a
"}
(23,1,1) = {"
a
a
a
a
a
a
a
a
a
a
a
a
a
a
a
a
a
a
a
m
m
m
m
B
L
F
x
x
x
m
m
a
a
a
a
a
a
a
a
a
a
a
a
a
a
a
a
a
a
a
"}
(24,1,1) = {"
a
a
a
a
a
a
a
a
a
a
a
a
a
a
a
a
a
a
a
q
w
w
w
m
d
F
m
x
x
x
m
a
a
a
a
a
a
a
a
a
a
a
a
a
a
a
a
a
a
a
"}
(25,1,1) = {"
a
a
a
a
a
a
a
a
a
a
a
a
a
a
a
a
a
a
a
q
w
w
w
w
F
M
m
x
x
x
m
a
a
a
a
a
a
a
a
a
a
a
a
a
a
a
a
a
a
a
"}
(26,1,1) = {"
a
a
a
a
a
a
a
a
a
a
a
a
a
a
a
a
a
a
a
q
w
w
w
m
F
F
m
m
m
m
Z
a
a
a
a
a
a
a
a
a
a
a
a
a
a
a
a
a
a
a
"}
(27,1,1) = {"
a
a
a
a
a
a
a
a
a
a
a
a
a
a
a
a
a
a
a
q
w
w
w
m
F
F
m
i
q
q
u
a
a
a
a
a
a
a
a
a
a
a
a
a
a
a
a
a
a
a
"}
(28,1,1) = {"
a
a
a
a
a
a
a
a
a
a
a
a
a
a
a
a
a
a
a
q
w
w
w
m
F
C
m
q
q
q
q
a
a
a
a
a
a
a
a
a
a
a
a
a
a
a
a
a
a
a
"}
(29,1,1) = {"
a
a
a
a
a
a
a
a
a
a
a
a
a
a
a
a
a
a
a
m
m
m
m
m
X
F
q
q
q
m
m
a
a
a
a
a
a
a
a
a
a
a
a
a
a
a
a
a
a
a
"}
(30,1,1) = {"
a
a
a
a
a
a
a
a
a
a
a
a
a
a
a
a
a
a
a
a
m
R
P
y
p
Y
m
q
q
m
a
a
a
a
a
a
a
a
a
a
a
a
a
a
a
a
a
a
a
a
"}
(31,1,1) = {"
a
a
a
a
a
a
a
a
a
a
a
a
a
a
a
a
a
a
a
a
m
v
k
m
b
b
U
q
q
m
a
a
a
a
a
a
a
a
a
a
a
a
a
a
a
a
a
a
a
a
"}
(32,1,1) = {"
a
a
a
a
a
a
a
a
a
a
a
a
a
a
a
a
a
a
a
a
m
D
D
m
b
b
m
H
H
m
a
a
a
a
a
a
a
a
a
a
a
a
a
a
a
a
a
a
a
a
"}
(33,1,1) = {"
a
a
a
a
a
a
a
a
a
a
a
a
a
a
a
a
a
a
a
a
m
I
I
m
A
K
m
H
H
m
a
a
a
a
a
a
a
a
a
a
a
a
a
a
a
a
a
a
a
a
"}
(34,1,1) = {"
a
a
a
a
a
a
a
a
a
a
a
a
a
a
a
a
a
a
a
a
a
a
a
Z
W
q
Z
a
a
a
a
a
a
a
a
a
a
a
a
a
a
a
a
a
a
a
a
a
a
a
"}
(35,1,1) = {"
a
a
a
a
a
a
a
a
a
a
a
a
a
a
a
a
a
a
a
a
a
a
a
a
a
a
a
a
a
a
a
a
a
a
a
a
a
a
a
a
a
a
a
a
a
a
a
a
a
a
"}
(36,1,1) = {"
a
a
a
a
a
a
a
a
a
a
a
a
a
a
a
a
a
a
a
a
a
a
a
a
a
a
a
a
a
a
a
a
a
a
a
a
a
a
a
a
a
a
a
a
a
a
a
a
a
a
"}
(37,1,1) = {"
a
a
a
a
a
a
a
a
a
a
a
a
a
a
a
a
a
a
a
a
a
a
a
a
a
a
a
a
a
a
a
a
a
a
a
a
a
a
a
a
a
a
a
a
a
a
a
a
a
a
"}
(38,1,1) = {"
a
a
a
a
a
a
a
a
a
a
a
a
a
a
a
a
a
a
a
a
a
a
a
a
a
a
a
a
a
a
a
a
a
a
a
a
a
a
a
a
a
a
a
a
a
a
a
a
a
a
"}
(39,1,1) = {"
a
a
a
a
a
a
a
a
a
a
a
a
a
a
a
a
a
a
a
a
a
a
a
a
a
a
a
a
a
a
a
a
a
a
a
a
a
a
a
a
a
a
a
a
a
a
a
a
a
a
"}
(40,1,1) = {"
a
a
a
a
a
a
a
a
a
a
a
a
a
a
a
a
a
a
a
a
a
a
a
a
a
a
a
a
a
a
a
a
a
a
a
a
a
a
a
a
a
a
a
a
a
a
a
a
a
a
"}
(41,1,1) = {"
a
a
a
a
a
a
a
a
a
a
a
a
a
a
a
a
a
a
a
a
a
a
a
a
a
a
a
a
a
a
a
a
a
a
a
a
a
a
a
a
a
a
a
a
a
a
a
a
a
a
"}
(42,1,1) = {"
a
a
a
a
a
a
a
a
a
a
a
a
a
a
a
a
a
a
a
a
a
a
a
a
a
a
a
a
a
a
a
a
a
a
a
a
a
a
a
a
a
a
a
a
a
a
a
a
a
a
"}
(43,1,1) = {"
a
a
a
a
a
a
a
a
a
a
a
a
a
a
a
a
a
a
a
a
a
a
a
a
a
a
a
a
a
a
a
a
a
a
a
a
a
a
a
a
a
a
a
a
a
a
a
a
a
a
"}
(44,1,1) = {"
a
a
a
a
a
a
a
a
a
a
a
a
a
a
a
a
a
a
a
a
a
a
a
a
a
a
a
a
a
a
a
a
a
a
a
a
a
a
a
a
a
a
a
a
a
a
a
a
a
a
"}
(45,1,1) = {"
a
a
a
a
a
a
a
a
a
a
a
a
a
a
a
a
a
a
a
a
a
a
a
a
a
a
a
a
a
a
a
a
a
a
a
a
a
a
a
a
a
a
a
a
a
a
a
a
a
a
"}
(46,1,1) = {"
a
a
a
a
a
a
a
a
a
a
a
a
a
a
a
a
a
a
a
a
a
a
a
a
a
a
a
a
a
a
a
a
a
a
a
a
a
a
a
a
a
a
a
a
a
a
a
a
a
a
"}
(47,1,1) = {"
a
a
a
a
a
a
a
a
a
a
a
a
a
a
a
a
a
a
a
a
a
a
a
a
a
a
a
a
a
a
a
a
a
a
a
a
a
a
a
a
a
a
a
a
a
a
a
a
a
a
"}
(48,1,1) = {"
a
a
a
a
a
a
a
a
a
a
a
a
a
a
a
a
a
a
a
a
a
a
a
a
a
a
a
a
a
a
a
a
a
a
a
a
a
a
a
a
a
a
a
a
a
a
a
a
a
a
"}
(49,1,1) = {"
a
a
a
a
a
a
a
a
a
a
a
a
a
a
a
a
a
a
a
a
a
a
a
a
a
a
a
a
a
a
a
a
a
a
a
a
a
a
a
a
a
a
a
a
a
a
a
a
a
a
"}
(50,1,1) = {"
a
a
a
a
a
a
a
a
a
a
a
a
a
a
a
a
a
a
a
a
a
a
a
a
a
a
a
a
a
a
a
a
a
a
a
a
a
a
a
a
a
a
a
a
a
a
a
a
a
a
"}
