//MAP CONVERTED BY dmm2tgm.py THIS HEADER COMMENT PREVENTS RECONVERSION, DO NOT REMOVE
"aN" = (
/obj/machinery/computer/shuttle/white_ship{
	dir = 4
	},
/turf/simulated/floor/mineral/plastitanium,
/area/space)
"aY" = (
/obj/effect/turf_decal/stripes/line,
/turf/simulated/floor/plasteel{
	dir = 1;
	icon_state = "neutral"
	},
/area/space)
"bf" = (
/obj/structure/sign/poster/official/random/directional/south,
/turf/simulated/floor/mineral/titanium,
/area/space)
"bB" = (
/turf/simulated/floor/plasteel{
	dir = 9;
	icon_state = "neutral"
	},
/area/space)
"ch" = (
/obj/effect/turf_decal/stripes/line{
	dir = 4
	},
/turf/simulated/floor/plasteel{
	dir = 8;
	icon_state = "neutral"
	},
/area/space)
"eV" = (
/obj/effect/map_effect/marker/mapmanip/submap/insert/space_ruin/white_ship/medbay,
/turf/template_noop,
/area/space)
"ff" = (
/obj/effect/turf_decal/stripes/line{
	dir = 8
	},
/turf/simulated/floor/plasteel{
	dir = 4;
	icon_state = "neutral"
	},
/area/space)
"fp" = (
/turf/simulated/floor/plasteel{
	dir = 6;
	icon_state = "neutral"
	},
/area/space)
"fw" = (
/turf/simulated/floor/mineral/titanium,
/area/space)
"fM" = (
/turf/simulated/floor/plating,
/area/space)
"gQ" = (
/obj/machinery/door/airlock/titanium{
	name = "Escape Pod Airlock"
	},
/turf/simulated/floor/mineral/titanium/blue/airless,
/area/space)
"hH" = (
/obj/machinery/door/airlock/external{
	name = "Arrival Airlock"
	},
/turf/simulated/floor/plasteel{
	dir = 1;
	icon_state = "neutral"
	},
/area/space)
"hK" = (
/obj/machinery/light/small,
/obj/machinery/atmospherics/unary/portables_connector{
	dir = 8
	},
/obj/machinery/atmospherics/portable/canister/air,
/turf/simulated/floor/plating,
/area/space)
"ip" = (
/turf/simulated/floor/mineral/titanium/blue/airless,
/area/space)
"iv" = (
/turf/simulated/floor/wood,
/area/space)
"jb" = (
/obj/structure/chair/comfy/shuttle{
	dir = 8
	},
/turf/simulated/floor/mineral/titanium/blue/airless,
/area/space)
"jf" = (
/obj/structure/table,
/obj/item/radio{
	pixel_x = -6;
	pixel_y = 6
	},
/obj/item/radio{
	pixel_y = 4
	},
/obj/item/radio{
	pixel_x = 6;
	pixel_y = 6
	},
/turf/simulated/floor/mineral/titanium,
/area/space)
"jy" = (
/obj/structure/table/reinforced,
/turf/simulated/floor/carpet/black,
/area/space)
"kz" = (
/obj/effect/spawner/random/dirt/often,
/turf/simulated/floor/plating,
/area/space)
"lm" = (
/obj/structure/chair/office/dark{
	dir = 1
	},
/turf/simulated/floor/carpet/black,
/area/space)
"mo" = (
/obj/docking_port/stationary/whiteship{
	dir = 8;
	id = "whiteship_away";
	name = "Deep Space"
	},
/obj/docking_port/mobile/whiteship,
/turf/simulated/floor/plating,
/area/space)
"mr" = (
/obj/structure/chair/comfy/shuttle{
	dir = 8
	},
/turf/simulated/floor/mineral/plastitanium,
/area/space)
"mz" = (
/turf/simulated/floor/plasteel{
	icon_state = "neutralcorner"
	},
/area/space)
"oF" = (
/turf/simulated/floor/plasteel{
	icon_state = "neutral"
	},
/area/space)
"pz" = (
/obj/structure/shuttle/engine/propulsion/burst{
	dir = 8
	},
/turf/simulated/wall/mineral/titanium,
/area/space)
"qh" = (
/obj/structure/table/reinforced,
/obj/item/analyzer,
/turf/simulated/floor/mineral/plastitanium,
/area/space)
"qJ" = (
/obj/effect/spawner/random/pool/whiteship_mob,
/turf/simulated/floor/mineral/titanium,
/area/space)
"rh" = (
/obj/structure/chair/comfy/shuttle,
/turf/simulated/floor/mineral/titanium/blue/airless,
/area/space)
"rk" = (
/obj/effect/spawner/random/dirt/often,
/obj/machinery/atmospherics/pipe/simple/hidden{
	dir = 5
	},
/turf/simulated/floor/mineral/titanium,
/area/space)
"rN" = (
/obj/structure/lattice/catwalk,
/obj/structure/lattice/catwalk,
/turf/space,
/area/space)
"sA" = (
/obj/machinery/door/airlock/external{
	name = "Arrival Airlock"
	},
/turf/simulated/floor/plasteel{
	icon_state = "neutral"
	},
/area/space)
"sU" = (
/turf/simulated/floor/plasteel{
	dir = 8;
	icon_state = "neutralcorner"
	},
/area/space)
"uo" = (
/turf/simulated/floor/plasteel{
	dir = 4;
	icon_state = "neutral"
	},
/area/space)
"wz" = (
/turf/simulated/floor/mineral/titanium/blue,
/area/space)
"wN" = (
/turf/space,
/area/space)
"xc" = (
/obj/effect/spawner/random/dirt/often,
/obj/machinery/door/airlock/titanium,
/obj/machinery/atmospherics/pipe/simple/hidden,
/turf/simulated/floor/plating,
/area/space)
"xp" = (
/turf/simulated/floor/plasteel{
	dir = 8;
	icon_state = "neutral"
	},
/area/space)
"xE" = (
/obj/machinery/light/small{
	dir = 4
	},
/obj/item/salvage/ruin/pirate,
/turf/simulated/floor/mineral/titanium,
/area/space)
"yk" = (
/obj/structure/shuttle/engine/propulsion/burst{
	dir = 4
	},
/turf/simulated/wall/mineral/titanium,
/area/space)
"yl" = (
/obj/machinery/light/small{
	dir = 1
	},
/turf/simulated/floor/mineral/titanium,
/area/space)
"yK" = (
/obj/structure/shuttle/engine/propulsion{
	dir = 4;
	icon_state = "burst_r"
	},
/turf/simulated/floor/plating/airless,
/area/space)
"zz" = (
/obj/item/gps/ruin{
	gpstag = "NT Medical Ship";
	pixel_x = -32
	},
/turf/simulated/floor/plating,
/area/space)
"zU" = (
/obj/effect/spawner/random/dirt/often,
/obj/machinery/atmospherics/pipe/simple/hidden,
/turf/simulated/floor/mineral/titanium,
/area/space)
"Am" = (
/turf/simulated/wall,
/area/space)
"AR" = (
/obj/effect/map_effect/marker/mapmanip/submap/insert/space_ruin/white_ship/storage,
/turf/simulated/floor/plating,
/area/space)
"By" = (
/obj/structure/lattice/catwalk,
/turf/space,
/area/space)
"Cp" = (
/obj/structure/closet/crate,
/obj/item/flashlight/flare,
/obj/item/flashlight/flare,
/obj/item/flashlight/flare,
/obj/item/flashlight/flare/glowstick/blue,
/obj/item/flashlight/flare/glowstick/blue,
/obj/item/flashlight/flare/glowstick/blue,
/turf/simulated/floor/mineral/titanium,
/area/space)
"CC" = (
/turf/simulated/floor/plasteel,
/area/space)
"Dm" = (
/obj/machinery/computer/nonfunctional{
	dir = 4
	},
/turf/simulated/floor/mineral/plastitanium,
/area/space)
"Dx" = (
/obj/structure/chair/comfy/shuttle{
	dir = 4
	},
/turf/simulated/floor/mineral/titanium/blue/airless,
/area/space)
"DO" = (
/obj/machinery/door/airlock/multi_tile/glass{
	dir = 1
	},
/turf/simulated/floor/plasteel{
	dir = 4;
	icon_state = "neutral"
	},
/area/space)
"Ee" = (
/turf/simulated/floor/plasteel{
	icon_state = "neutralcorner";
	dir = 4
	},
/area/space)
"Eo" = (
/obj/machinery/door/airlock/external/glass,
/turf/space,
/area/space)
"Fc" = (
/obj/structure/table,
/obj/item/storage/box/lights/mixed,
/obj/item/stock_parts/cell{
	charge = 100;
	maxcharge = 15000;
	pixel_x = -3;
	pixel_y = -3
	},
/turf/simulated/floor/plating,
/area/space)
"Fp" = (
/obj/effect/turf_decal/stripes/line{
	icon_state = "warninglinecorner";
	dir = 8
	},
/turf/simulated/floor/plasteel{
	dir = 5;
	icon_state = "neutral"
	},
/area/space)
"FH" = (
/obj/structure/chair/comfy/shuttle{
	dir = 8
	},
/obj/effect/spawner/random/pool/whiteship_mob,
/turf/simulated/floor/mineral/plastitanium,
/area/space)
"GL" = (
/obj/effect/turf_decal/stripes/line{
	dir = 10
	},
/obj/structure/sign/vacuum/external{
	pixel_y = -32
	},
/turf/simulated/floor/plasteel{
	dir = 1;
	icon_state = "neutral"
	},
/area/space)
"Hw" = (
/obj/structure/shuttle/engine/heater{
	dir = 4
	},
/obj/structure/window/reinforced{
	dir = 8
	},
/turf/simulated/floor/plating/airless,
/area/space)
"IS" = (
/obj/structure/table,
/obj/item/storage/toolbox/mechanical,
/obj/item/multitool{
	pixel_x = -6
	},
/turf/simulated/floor/plating,
/area/space)
"IT" = (
/turf/template_noop,
/area/space)
"Jj" = (
/obj/machinery/door/airlock/multi_tile/glass{
	dir = 4
	},
/turf/simulated/floor/mineral/plastitanium,
/area/space)
"Jv" = (
/turf/simulated/wall/mineral/titanium,
/area/space)
"Jx" = (
/obj/structure/sign/vacuum/external{
	pixel_y = -32
	},
/obj/effect/spawner/random/dirt/often,
/turf/simulated/floor/plating,
/area/space)
"LB" = (
/turf/simulated/floor/plasteel{
	dir = 1;
	icon_state = "neutralcorner"
	},
/area/space)
"Mh" = (
/obj/structure/extinguisher_cabinet{
	name = "north bump";
	pixel_y = 30
	},
/turf/simulated/floor/mineral/titanium,
/area/space)
"MN" = (
/obj/machinery/light/small{
	dir = 1
	},
/obj/effect/spawner/random/dirt/often,
/turf/simulated/floor/plating,
/area/space)
"MS" = (
/turf/simulated/floor/plasteel{
	dir = 1;
	icon_state = "neutral"
	},
/area/space)
"Nc" = (
/obj/structure/sign/poster/official/random/directional/north,
/turf/simulated/floor/mineral/titanium,
/area/space)
"ND" = (
/turf/simulated/floor/plating/airless,
/area/space)
"NU" = (
/obj/machinery/door/airlock/titanium/glass,
/turf/simulated/floor/mineral/titanium,
/area/space)
"Ok" = (
/obj/machinery/light/small,
/turf/simulated/floor/mineral/titanium,
/area/space)
"Oy" = (
/turf/simulated/floor/mineral/plastitanium,
/area/space)
"OI" = (
/turf/simulated/floor/carpet/black,
/area/space)
"PH" = (
/obj/effect/turf_decal/stripes/line{
	dir = 6
	},
/turf/simulated/floor/plasteel{
	dir = 8;
	icon_state = "neutral"
	},
/area/space)
"PK" = (
/obj/structure/table/reinforced,
/obj/item/whiteship_port_generator,
/turf/simulated/floor/mineral/plastitanium,
/area/space)
"PR" = (
/obj/effect/turf_decal/stripes/line{
	dir = 5
	},
/turf/simulated/floor/plasteel{
	icon_state = "neutralcorner";
	dir = 8
	},
/area/space)
"Ry" = (
/turf/simulated/wall/mineral/titanium/nodiagonal,
/area/space)
"To" = (
/obj/structure/table/reinforced,
/obj/item/flashlight/lamp/green,
/turf/simulated/floor/carpet/black,
/area/space)
"TJ" = (
/obj/structure/shuttle/engine/propulsion/burst{
	dir = 1
	},
/turf/simulated/wall/mineral/titanium,
/area/space)
"Uj" = (
/obj/effect/map_effect/marker/mapmanip/submap/insert/space_ruin/white_ship/gun_room,
/turf/simulated/wall/mineral/titanium,
/area/space)
"Ux" = (
/turf/simulated/floor/plasteel{
	dir = 10;
	icon_state = "neutral"
	},
/area/space)
"Vj" = (
/obj/effect/turf_decal/stripes/line{
	dir = 9
	},
/turf/simulated/floor/plasteel{
	icon_state = "neutral"
	},
/area/space)
"Vx" = (
/obj/effect/spawner/window/reinforced/grilled,
/turf/simulated/floor/plating,
/area/space)
"Wy" = (
/obj/effect/turf_decal/stripes/line{
	dir = 10
	},
/turf/simulated/floor/plasteel{
	dir = 4;
	icon_state = "neutral"
	},
/area/space)
"WJ" = (
/obj/effect/spawner/random/oil/often,
/obj/machinery/atmospherics/pipe/simple/hidden{
	dir = 6
	},
/obj/effect/spawner/random/pool/whiteship_mob,
/turf/simulated/floor/plating,
/area/space)
"Xr" = (
/obj/effect/turf_decal/stripes/line{
	dir = 1
	},
/turf/simulated/floor/plasteel{
	icon_state = "neutral"
	},
/area/space)
"XH" = (
/obj/machinery/light{
	dir = 4
	},
/obj/structure/chair/comfy/shuttle{
	dir = 8
	},
/turf/simulated/floor/mineral/plastitanium,
/area/space)
"Yk" = (
/obj/effect/spawner/airlock/w_to_e/long/square,
/turf/simulated/wall/mineral/titanium,
/area/space)
"YE" = (
/obj/effect/spawner/window/shuttle,
/turf/simulated/floor/plating,
/area/space)
"ZM" = (
/obj/machinery/door/airlock/multi_tile/glass{
	dir = 4
	},
/turf/simulated/floor/plasteel{
	dir = 1;
	icon_state = "neutral"
	},
/area/space)
"ZO" = (
/obj/machinery/computer/nonfunctional{
	dir = 1
	},
/turf/simulated/floor/mineral/titanium/blue/airless,
/area/space)

(1,1,1) = {"
wN
wN
wN
wN
wN
wN
wN
wN
wN
wN
wN
wN
wN
wN
wN
wN
wN
wN
wN
wN
wN
wN
wN
wN
wN
wN
wN
wN
wN
wN
wN
wN
wN
wN
wN
wN
wN
wN
wN
wN
wN
wN
wN
wN
wN
wN
wN
wN
wN
wN
wN
wN
wN
wN
wN
wN
wN
wN
wN
wN
wN
wN
wN
wN
wN
wN
wN
wN
wN
wN
wN
wN
wN
wN
wN
wN
wN
"}
(2,1,1) = {"
wN
wN
wN
wN
wN
wN
wN
wN
wN
wN
wN
wN
wN
wN
wN
wN
wN
wN
wN
wN
wN
wN
wN
wN
wN
wN
wN
wN
wN
wN
wN
wN
wN
wN
wN
wN
wN
wN
wN
wN
wN
wN
wN
wN
wN
wN
wN
wN
wN
wN
wN
wN
wN
wN
wN
wN
wN
wN
wN
wN
wN
wN
wN
wN
wN
wN
wN
wN
wN
wN
wN
wN
wN
wN
wN
wN
wN
"}
(3,1,1) = {"
wN
wN
wN
wN
wN
wN
wN
wN
wN
wN
wN
wN
wN
wN
wN
wN
wN
wN
wN
wN
wN
wN
wN
wN
wN
wN
wN
wN
wN
wN
wN
wN
wN
wN
wN
wN
wN
wN
wN
wN
wN
wN
wN
wN
wN
wN
wN
wN
wN
wN
wN
wN
wN
wN
wN
wN
wN
wN
wN
wN
wN
wN
wN
wN
wN
wN
wN
wN
wN
wN
wN
wN
wN
wN
wN
wN
wN
"}
(4,1,1) = {"
wN
wN
wN
wN
wN
wN
wN
wN
wN
wN
wN
wN
wN
wN
wN
wN
wN
wN
wN
wN
wN
wN
wN
wN
wN
wN
wN
wN
wN
wN
wN
wN
wN
wN
wN
wN
wN
wN
wN
wN
wN
wN
wN
wN
wN
wN
wN
wN
wN
wN
wN
wN
wN
wN
wN
wN
wN
wN
wN
wN
wN
wN
wN
wN
wN
wN
wN
wN
wN
wN
wN
wN
wN
wN
wN
wN
wN
"}
(5,1,1) = {"
wN
wN
wN
wN
wN
wN
wN
wN
wN
wN
wN
wN
wN
wN
wN
wN
wN
wN
wN
wN
wN
wN
wN
wN
wN
wN
wN
wN
wN
wN
wN
wN
wN
wN
wN
wN
wN
wN
wN
wN
wN
wN
wN
wN
wN
wN
wN
wN
wN
wN
wN
wN
wN
wN
wN
wN
wN
wN
wN
wN
wN
wN
wN
wN
wN
wN
wN
wN
wN
wN
wN
wN
wN
wN
wN
wN
wN
"}
(6,1,1) = {"
wN
wN
wN
wN
wN
wN
wN
wN
wN
wN
wN
wN
wN
wN
wN
wN
wN
wN
wN
wN
wN
wN
wN
wN
wN
wN
wN
wN
wN
wN
wN
wN
wN
wN
wN
wN
wN
wN
wN
wN
wN
wN
wN
wN
wN
wN
wN
wN
wN
wN
wN
wN
wN
wN
wN
wN
wN
wN
wN
wN
wN
wN
wN
wN
wN
wN
wN
wN
wN
wN
wN
wN
wN
wN
wN
wN
wN
"}
(7,1,1) = {"
wN
wN
wN
wN
wN
wN
wN
wN
wN
wN
wN
wN
wN
wN
wN
wN
wN
wN
wN
wN
wN
wN
wN
wN
wN
wN
wN
wN
wN
wN
wN
wN
wN
wN
wN
wN
wN
wN
wN
wN
wN
wN
wN
wN
wN
wN
wN
wN
wN
wN
wN
wN
wN
wN
wN
wN
wN
wN
wN
wN
wN
wN
wN
wN
wN
wN
wN
wN
wN
wN
wN
wN
wN
wN
wN
wN
wN
"}
(8,1,1) = {"
wN
wN
wN
wN
wN
wN
wN
wN
wN
wN
wN
wN
wN
wN
wN
wN
wN
wN
wN
wN
wN
wN
wN
wN
wN
wN
wN
wN
wN
wN
wN
wN
wN
wN
wN
wN
wN
wN
wN
wN
wN
wN
wN
wN
wN
wN
wN
wN
wN
wN
wN
wN
wN
wN
wN
wN
wN
wN
wN
wN
wN
wN
wN
wN
wN
wN
wN
wN
wN
wN
wN
wN
wN
wN
wN
wN
wN
"}
(9,1,1) = {"
wN
wN
wN
wN
wN
IT
IT
IT
IT
Jv
YE
YE
Jv
IT
IT
IT
IT
wN
wN
wN
wN
wN
wN
wN
wN
wN
wN
wN
wN
wN
wN
wN
wN
wN
wN
wN
wN
wN
wN
wN
wN
wN
wN
wN
wN
wN
wN
wN
wN
wN
wN
wN
wN
wN
wN
wN
wN
wN
wN
wN
wN
wN
wN
wN
wN
wN
wN
wN
wN
wN
wN
wN
wN
wN
wN
wN
wN
"}
(10,1,1) = {"
wN
wN
wN
wN
wN
IT
IT
IT
Jv
Jv
Dm
aN
Jv
Jv
IT
IT
IT
wN
wN
wN
wN
wN
wN
wN
wN
wN
wN
wN
wN
wN
wN
wN
wN
wN
wN
wN
wN
wN
wN
wN
wN
wN
wN
wN
wN
wN
wN
wN
wN
wN
wN
wN
wN
wN
wN
wN
wN
wN
wN
wN
wN
wN
wN
wN
wN
wN
wN
wN
wN
wN
wN
wN
wN
wN
wN
wN
wN
"}
(11,1,1) = {"
wN
wN
wN
wN
wN
IT
IT
IT
Jv
qh
FH
FH
PK
Jv
IT
IT
IT
wN
wN
wN
wN
wN
wN
wN
wN
wN
wN
wN
wN
wN
wN
wN
wN
wN
wN
wN
wN
wN
wN
wN
wN
wN
wN
wN
wN
wN
wN
wN
wN
wN
wN
wN
wN
wN
wN
wN
wN
wN
wN
wN
wN
wN
wN
wN
wN
wN
wN
wN
wN
wN
wN
wN
wN
wN
wN
wN
wN
"}
(12,1,1) = {"
wN
wN
wN
wN
wN
IT
IT
IT
Jv
XH
Oy
Oy
mr
Jv
IT
IT
IT
wN
wN
wN
wN
wN
wN
wN
wN
wN
wN
wN
wN
wN
wN
wN
wN
wN
wN
wN
wN
wN
wN
wN
wN
wN
wN
wN
wN
wN
wN
wN
wN
wN
wN
wN
wN
wN
wN
wN
wN
wN
wN
wN
wN
wN
wN
wN
wN
wN
wN
wN
wN
wN
wN
wN
wN
wN
wN
wN
wN
"}
(13,1,1) = {"
wN
wN
wN
wN
wN
IT
Jv
Jv
Jv
Jv
Oy
Jj
Jv
Jv
Jv
Jv
eV
wN
wN
wN
wN
wN
wN
wN
wN
wN
wN
wN
wN
wN
wN
wN
wN
wN
wN
wN
wN
wN
wN
wN
wN
wN
wN
wN
wN
wN
wN
wN
wN
wN
wN
wN
wN
wN
wN
wN
wN
wN
wN
wN
wN
wN
wN
wN
wN
wN
wN
wN
wN
wN
wN
wN
wN
wN
wN
wN
wN
"}
(14,1,1) = {"
wN
wN
wN
wN
wN
IT
Jv
jf
Cp
Jv
yl
fw
Jv
wz
wz
Jv
IT
wN
wN
wN
wN
wN
wN
wN
wN
wN
wN
wN
wN
wN
wN
wN
wN
wN
wN
wN
wN
wN
wN
wN
wN
wN
wN
wN
wN
wN
wN
wN
wN
wN
wN
wN
wN
wN
wN
wN
wN
wN
wN
wN
wN
wN
wN
wN
wN
wN
wN
wN
wN
wN
wN
wN
wN
wN
wN
wN
wN
"}
(15,1,1) = {"
wN
wN
wN
wN
wN
IT
Jv
xE
qJ
NU
fw
fw
Jv
wz
wz
Jv
IT
wN
wN
wN
wN
wN
wN
wN
wN
wN
wN
wN
wN
wN
wN
wN
wN
wN
wN
wN
wN
wN
wN
wN
wN
wN
wN
wN
wN
wN
wN
wN
wN
wN
wN
wN
wN
wN
wN
wN
wN
wN
wN
wN
wN
wN
wN
wN
wN
wN
wN
wN
wN
wN
wN
wN
wN
wN
wN
wN
wN
"}
(16,1,1) = {"
wN
wN
wN
wN
wN
Jv
Jv
Jv
Jv
Uj
Nc
fw
wz
wz
wz
Jv
Jv
wN
wN
wN
wN
wN
wN
wN
wN
wN
wN
wN
wN
wN
wN
wN
wN
wN
wN
wN
wN
wN
wN
wN
wN
wN
wN
wN
wN
wN
wN
wN
wN
wN
wN
wN
wN
wN
wN
wN
wN
wN
wN
wN
wN
wN
wN
wN
wN
wN
wN
wN
wN
wN
wN
wN
wN
wN
wN
wN
wN
"}
(17,1,1) = {"
wN
wN
wN
wN
wN
fM
iv
iv
iv
Jv
Mh
fw
Jv
wz
wz
wz
Jv
wN
wN
wN
wN
wN
wN
wN
wN
wN
wN
wN
wN
wN
wN
wN
wN
wN
wN
wN
wN
wN
wN
wN
wN
wN
wN
wN
wN
wN
wN
wN
wN
wN
wN
wN
wN
wN
wN
wN
wN
wN
wN
wN
wN
wN
wN
wN
wN
wN
wN
wN
wN
wN
wN
wN
wN
wN
wN
wN
wN
"}
(18,1,1) = {"
wN
wN
wN
wN
wN
fM
iv
iv
iv
iv
fw
Ok
Jv
wz
wz
wz
Jv
wN
wN
wN
wN
wN
wN
wN
wN
wN
wN
wN
wN
wN
wN
wN
wN
wN
wN
wN
wN
wN
wN
wN
wN
wN
wN
wN
wN
wN
wN
wN
wN
wN
wN
wN
wN
wN
wN
wN
wN
wN
wN
wN
wN
wN
wN
wN
wN
wN
wN
wN
wN
wN
wN
wN
wN
wN
wN
wN
wN
"}
(19,1,1) = {"
wN
wN
wN
wN
wN
fM
iv
iv
iv
Jv
fw
fw
Jv
Jv
Jv
Jv
Ry
wN
wN
wN
wN
wN
wN
wN
wN
wN
wN
wN
wN
wN
wN
wN
wN
wN
wN
wN
wN
wN
wN
wN
wN
wN
wN
wN
wN
wN
wN
wN
wN
wN
wN
wN
wN
wN
wN
wN
wN
wN
wN
wN
wN
wN
wN
wN
wN
wN
wN
wN
wN
wN
wN
wN
wN
wN
wN
wN
wN
"}
(20,1,1) = {"
wN
wN
wN
wN
wN
fM
iv
iv
iv
Jv
fw
fw
Jv
zz
fM
fM
AR
wN
wN
wN
wN
wN
wN
wN
wN
wN
wN
wN
wN
wN
wN
wN
wN
wN
wN
wN
wN
wN
wN
wN
wN
wN
wN
wN
wN
wN
wN
wN
wN
wN
wN
wN
wN
wN
wN
wN
wN
wN
wN
wN
wN
wN
wN
wN
wN
wN
wN
wN
wN
wN
wN
wN
wN
wN
wN
wN
wN
"}
(21,1,1) = {"
wN
wN
wN
wN
wN
fM
iv
iv
iv
Jv
fw
bf
Jv
fM
fM
fM
fM
wN
wN
wN
wN
wN
wN
wN
wN
wN
wN
wN
wN
wN
wN
wN
wN
wN
wN
wN
wN
wN
wN
wN
wN
wN
wN
wN
wN
wN
wN
wN
wN
wN
wN
wN
wN
wN
wN
wN
wN
wN
wN
wN
wN
wN
wN
wN
wN
wN
wN
wN
wN
wN
wN
wN
wN
wN
wN
wN
wN
"}
(22,1,1) = {"
wN
wN
wN
wN
wN
Jv
Jv
Jv
Jv
Jv
yl
fw
fM
fM
fM
Jv
Jv
wN
wN
wN
wN
wN
wN
wN
wN
wN
wN
wN
wN
wN
wN
wN
wN
wN
wN
wN
wN
wN
wN
wN
wN
wN
wN
wN
wN
wN
wN
wN
wN
wN
wN
wN
wN
wN
wN
wN
wN
wN
wN
wN
wN
wN
wN
wN
wN
wN
wN
wN
wN
wN
wN
wN
wN
wN
wN
wN
wN
"}
(23,1,1) = {"
wN
wN
wN
wN
wN
IT
Jv
IS
WJ
xc
zU
rk
Jv
fM
fM
Jv
IT
wN
wN
wN
wN
wN
wN
wN
wN
wN
wN
wN
wN
wN
wN
wN
wN
wN
wN
wN
wN
wN
wN
wN
wN
wN
wN
wN
wN
wN
wN
wN
wN
wN
wN
wN
wN
wN
wN
wN
wN
wN
wN
wN
wN
wN
wN
wN
wN
wN
wN
wN
wN
wN
wN
wN
wN
wN
wN
wN
wN
"}
(24,1,1) = {"
wN
wN
wN
wN
wN
IT
Jv
Fc
hK
Jv
kz
kz
Yk
fM
fM
Jv
IT
wN
wN
wN
wN
wN
wN
wN
wN
wN
wN
wN
wN
wN
wN
wN
wN
wN
wN
wN
wN
wN
wN
wN
wN
wN
wN
wN
wN
wN
wN
wN
wN
wN
wN
wN
wN
wN
wN
wN
wN
wN
wN
wN
wN
wN
wN
wN
wN
wN
wN
wN
wN
wN
wN
wN
wN
wN
wN
wN
wN
"}
(25,1,1) = {"
wN
wN
wN
wN
wN
IT
Jv
Hw
Hw
Jv
kz
kz
Jv
ND
ND
Jv
IT
Am
Am
Am
Am
Am
Am
Am
wN
wN
wN
wN
wN
wN
wN
wN
wN
wN
wN
wN
wN
wN
wN
wN
wN
wN
wN
wN
wN
wN
wN
wN
wN
wN
wN
wN
wN
wN
wN
wN
wN
wN
wN
wN
wN
wN
wN
wN
wN
wN
wN
wN
wN
wN
wN
wN
wN
wN
wN
wN
wN
"}
(26,1,1) = {"
wN
wN
wN
wN
wN
IT
Jv
yK
yK
Jv
MN
Jx
Jv
ND
ND
Jv
IT
Vx
mz
uo
uo
uo
Ee
Am
wN
wN
wN
wN
wN
wN
wN
wN
wN
wN
wN
wN
wN
wN
wN
wN
wN
wN
wN
wN
wN
wN
wN
wN
wN
wN
wN
wN
wN
wN
wN
wN
wN
wN
wN
wN
wN
wN
wN
wN
wN
wN
wN
wN
wN
wN
wN
wN
wN
wN
wN
wN
wN
"}
(27,1,1) = {"
wN
wN
wN
wN
wN
IT
IT
IT
IT
Ry
mo
fM
Ry
IT
IT
IT
IT
Vx
oF
CC
CC
CC
MS
Am
wN
wN
wN
wN
wN
wN
wN
wN
wN
wN
wN
wN
wN
wN
wN
wN
wN
wN
wN
wN
wN
wN
wN
wN
wN
wN
wN
wN
wN
wN
wN
wN
wN
wN
wN
wN
wN
wN
wN
wN
wN
wN
wN
wN
wN
wN
wN
wN
wN
wN
wN
wN
wN
"}
(28,1,1) = {"
wN
wN
wN
wN
wN
wN
wN
wN
wN
Am
sA
hH
Am
wN
wN
wN
Am
Am
oF
wN
wN
wN
MS
Am
wN
wN
wN
wN
wN
wN
wN
wN
wN
wN
wN
wN
wN
wN
wN
wN
wN
wN
wN
wN
wN
wN
wN
wN
wN
wN
wN
wN
wN
wN
wN
wN
wN
wN
wN
wN
wN
wN
wN
wN
wN
wN
wN
wN
wN
wN
wN
wN
wN
wN
wN
wN
wN
"}
(29,1,1) = {"
wN
wN
wN
wN
wN
wN
wN
wN
wN
Am
Vj
GL
Am
wN
wN
wN
Am
mz
fp
wN
wN
wN
MS
Am
wN
wN
wN
wN
wN
wN
wN
wN
wN
wN
wN
wN
wN
wN
wN
wN
wN
wN
wN
wN
wN
wN
wN
wN
wN
wN
wN
wN
wN
wN
wN
wN
wN
wN
wN
wN
wN
wN
wN
wN
wN
wN
wN
wN
wN
wN
wN
wN
wN
wN
wN
wN
wN
"}
(30,1,1) = {"
wN
wN
wN
wN
wN
wN
wN
wN
wN
Am
Xr
aY
Am
Am
Am
Am
Am
oF
CC
CC
CC
To
jy
Am
wN
wN
wN
wN
wN
wN
wN
wN
wN
wN
wN
wN
wN
wN
wN
wN
wN
wN
wN
wN
wN
wN
wN
wN
wN
wN
wN
wN
wN
wN
wN
wN
wN
wN
wN
wN
wN
wN
wN
wN
wN
wN
wN
wN
wN
wN
wN
wN
wN
wN
wN
wN
wN
"}
(31,1,1) = {"
wN
wN
wN
wN
wN
wN
wN
wN
wN
Vx
Xr
Fp
ff
ff
ff
Wy
DO
fp
CC
CC
CC
jy
OI
wN
wN
wN
wN
wN
wN
wN
wN
wN
wN
wN
wN
wN
wN
wN
wN
wN
wN
wN
wN
wN
wN
wN
wN
wN
wN
wN
wN
wN
wN
wN
wN
wN
wN
wN
wN
wN
wN
wN
wN
wN
wN
wN
wN
wN
wN
wN
wN
wN
wN
wN
wN
wN
wN
"}
(32,1,1) = {"
wN
wN
wN
wN
wN
wN
wN
wN
wN
Vx
PR
ch
ch
ch
ch
PH
xp
Ux
CC
CC
CC
jy
lm
wN
wN
wN
wN
wN
wN
wN
wN
wN
wN
wN
wN
wN
wN
wN
wN
wN
wN
wN
wN
wN
wN
wN
wN
wN
wN
wN
wN
wN
wN
wN
wN
wN
wN
wN
wN
wN
wN
wN
wN
wN
wN
wN
wN
wN
wN
wN
wN
wN
wN
wN
wN
wN
wN
"}
(33,1,1) = {"
wN
wN
wN
wN
wN
wN
wN
wN
wN
Am
Vx
Vx
Vx
Am
Am
Am
Am
oF
CC
CC
CC
jy
jy
Am
wN
wN
wN
wN
wN
wN
wN
wN
wN
wN
wN
wN
wN
wN
wN
wN
wN
wN
wN
wN
wN
wN
wN
wN
wN
wN
wN
wN
wN
wN
wN
wN
wN
wN
wN
wN
wN
wN
wN
wN
wN
wN
wN
wN
wN
wN
wN
wN
wN
wN
wN
wN
wN
"}
(34,1,1) = {"
wN
wN
wN
wN
wN
wN
wN
wN
wN
wN
wN
wN
wN
wN
wN
wN
Am
sU
Ux
wN
wN
wN
MS
Am
wN
wN
wN
wN
wN
wN
wN
wN
wN
wN
wN
wN
wN
wN
wN
wN
wN
wN
wN
wN
wN
wN
wN
wN
wN
wN
wN
wN
wN
wN
wN
wN
wN
wN
wN
wN
wN
wN
wN
wN
wN
wN
wN
wN
wN
wN
wN
wN
wN
wN
wN
wN
wN
"}
(35,1,1) = {"
wN
wN
wN
wN
wN
wN
wN
wN
wN
wN
wN
wN
wN
wN
wN
wN
Am
Am
oF
wN
wN
wN
MS
Am
wN
wN
wN
wN
wN
wN
wN
wN
wN
wN
wN
wN
wN
wN
wN
wN
wN
wN
wN
wN
wN
wN
wN
wN
wN
wN
wN
wN
wN
wN
wN
wN
wN
wN
wN
wN
wN
wN
wN
wN
wN
wN
wN
wN
wN
wN
wN
wN
wN
wN
wN
wN
wN
"}
(36,1,1) = {"
wN
wN
wN
wN
wN
wN
wN
Jv
YE
Jv
wN
wN
wN
wN
wN
wN
wN
Vx
oF
CC
CC
CC
MS
Am
wN
wN
wN
wN
wN
wN
wN
wN
wN
wN
wN
wN
wN
wN
wN
wN
wN
wN
wN
wN
wN
wN
wN
wN
wN
wN
wN
wN
wN
wN
wN
wN
wN
wN
wN
wN
wN
wN
wN
wN
wN
wN
wN
wN
wN
wN
wN
wN
wN
wN
wN
wN
wN
"}
(37,1,1) = {"
wN
wN
wN
wN
wN
wN
wN
Jv
jb
Jv
wN
wN
wN
wN
wN
wN
wN
Vx
sU
Ux
bB
xp
LB
Am
wN
wN
wN
wN
wN
wN
wN
wN
wN
wN
wN
wN
wN
wN
wN
wN
wN
wN
wN
wN
wN
wN
wN
wN
wN
wN
wN
wN
wN
wN
wN
wN
wN
wN
wN
wN
wN
wN
wN
wN
wN
wN
wN
wN
wN
wN
wN
wN
wN
wN
wN
wN
wN
"}
(38,1,1) = {"
wN
wN
wN
wN
wN
wN
wN
Jv
jb
Jv
wN
wN
wN
wN
wN
wN
wN
Am
Am
oF
ZM
Am
Am
Am
wN
wN
wN
wN
wN
wN
wN
wN
wN
wN
wN
wN
wN
wN
wN
wN
wN
wN
wN
wN
wN
wN
wN
wN
wN
wN
wN
wN
wN
wN
wN
wN
wN
wN
wN
wN
wN
wN
wN
wN
wN
wN
wN
wN
wN
wN
wN
wN
wN
wN
wN
wN
wN
"}
(39,1,1) = {"
TJ
Jv
Jv
Jv
Jv
Jv
wN
yk
gQ
yk
wN
wN
wN
wN
Am
Am
Am
Am
wN
wN
wN
wN
wN
wN
wN
wN
wN
wN
wN
wN
wN
wN
wN
wN
wN
wN
wN
wN
wN
wN
wN
wN
wN
wN
wN
wN
wN
wN
wN
wN
wN
wN
wN
wN
wN
wN
wN
wN
wN
wN
wN
wN
wN
wN
wN
wN
wN
wN
wN
wN
wN
wN
wN
wN
wN
wN
wN
"}
(40,1,1) = {"
gQ
ip
rh
rh
ip
YE
wN
By
By
By
By
By
By
By
Eo
wN
wN
Eo
wN
wN
wN
wN
wN
wN
wN
wN
wN
wN
wN
wN
wN
wN
wN
wN
wN
wN
wN
wN
wN
wN
wN
wN
wN
wN
wN
wN
wN
wN
wN
wN
wN
wN
wN
wN
wN
wN
wN
wN
wN
wN
wN
wN
wN
wN
wN
wN
wN
wN
wN
wN
wN
wN
wN
wN
wN
wN
wN
"}
(41,1,1) = {"
Jv
ip
rh
rh
ZO
YE
By
By
By
By
By
By
By
By
Eo
wN
wN
Eo
wN
wN
wN
wN
wN
wN
wN
wN
wN
wN
wN
wN
wN
wN
wN
wN
wN
wN
wN
wN
wN
wN
wN
wN
wN
wN
wN
wN
wN
wN
wN
wN
wN
wN
wN
wN
wN
wN
wN
wN
wN
wN
wN
wN
wN
wN
wN
wN
wN
wN
wN
wN
wN
wN
wN
wN
wN
wN
wN
"}
(42,1,1) = {"
gQ
ip
rh
rh
ip
YE
wN
By
rN
By
By
By
By
By
Eo
wN
wN
Eo
wN
wN
wN
wN
wN
wN
wN
wN
wN
wN
wN
wN
wN
wN
wN
wN
wN
wN
wN
wN
wN
wN
wN
wN
wN
wN
wN
wN
wN
wN
wN
wN
wN
wN
wN
wN
wN
wN
wN
wN
wN
wN
wN
wN
wN
wN
wN
wN
wN
wN
wN
wN
wN
wN
wN
wN
wN
wN
wN
"}
(43,1,1) = {"
TJ
Jv
Jv
Jv
Jv
Jv
wN
pz
gQ
pz
wN
pz
gQ
pz
Am
Am
Am
Am
wN
wN
wN
wN
wN
wN
wN
wN
wN
wN
wN
wN
wN
wN
wN
wN
wN
wN
wN
wN
wN
wN
wN
wN
wN
wN
wN
wN
wN
wN
wN
wN
wN
wN
wN
wN
wN
wN
wN
wN
wN
wN
wN
wN
wN
wN
wN
wN
wN
wN
wN
wN
wN
wN
wN
wN
wN
wN
wN
"}
(44,1,1) = {"
wN
wN
wN
wN
wN
wN
wN
Jv
Dx
Jv
wN
Jv
Dx
Jv
wN
wN
wN
wN
wN
wN
wN
wN
wN
wN
wN
wN
wN
wN
wN
wN
wN
wN
wN
wN
wN
wN
wN
wN
wN
wN
wN
wN
wN
wN
wN
wN
wN
wN
wN
wN
wN
wN
wN
wN
wN
wN
wN
wN
wN
wN
wN
wN
wN
wN
wN
wN
wN
wN
wN
wN
wN
wN
wN
wN
wN
wN
wN
"}
(45,1,1) = {"
wN
wN
wN
wN
wN
wN
wN
Jv
Dx
Jv
wN
Jv
Dx
Jv
wN
wN
wN
wN
wN
wN
wN
wN
wN
wN
wN
wN
wN
wN
wN
wN
wN
wN
wN
wN
wN
wN
wN
wN
wN
wN
wN
wN
wN
wN
wN
wN
wN
wN
wN
wN
wN
wN
wN
wN
wN
wN
wN
wN
wN
wN
wN
wN
wN
wN
wN
wN
wN
wN
wN
wN
wN
wN
wN
wN
wN
wN
wN
"}
(46,1,1) = {"
wN
wN
wN
wN
wN
wN
wN
Jv
YE
Jv
wN
Jv
YE
Jv
wN
wN
wN
wN
wN
wN
wN
wN
wN
wN
wN
wN
wN
wN
wN
wN
wN
wN
wN
wN
wN
wN
wN
wN
wN
wN
wN
wN
wN
wN
wN
wN
wN
wN
wN
wN
wN
wN
wN
wN
wN
wN
wN
wN
wN
wN
wN
wN
wN
wN
wN
wN
wN
wN
wN
wN
wN
wN
wN
wN
wN
wN
wN
"}
(47,1,1) = {"
wN
wN
wN
wN
wN
wN
wN
wN
wN
wN
wN
wN
wN
wN
wN
wN
wN
wN
wN
wN
wN
wN
wN
wN
wN
wN
wN
wN
wN
wN
wN
wN
wN
wN
wN
wN
wN
wN
wN
wN
wN
wN
wN
wN
wN
wN
wN
wN
wN
wN
wN
wN
wN
wN
wN
wN
wN
wN
wN
wN
wN
wN
wN
wN
wN
wN
wN
wN
wN
wN
wN
wN
wN
wN
wN
wN
wN
"}
(48,1,1) = {"
wN
wN
wN
wN
wN
wN
wN
wN
wN
wN
wN
wN
wN
wN
wN
wN
wN
wN
wN
wN
wN
wN
wN
wN
wN
wN
wN
wN
wN
wN
wN
wN
wN
wN
wN
wN
wN
wN
wN
wN
wN
wN
wN
wN
wN
wN
wN
wN
wN
wN
wN
wN
wN
wN
wN
wN
wN
wN
wN
wN
wN
wN
wN
wN
wN
wN
wN
wN
wN
wN
wN
wN
wN
wN
wN
wN
wN
"}
(49,1,1) = {"
wN
wN
wN
wN
wN
wN
wN
wN
wN
wN
wN
wN
wN
wN
wN
wN
wN
wN
wN
wN
wN
wN
wN
wN
wN
wN
wN
wN
wN
wN
wN
wN
wN
wN
wN
wN
wN
wN
wN
wN
wN
wN
wN
wN
wN
wN
wN
wN
wN
wN
wN
wN
wN
wN
wN
wN
wN
wN
wN
wN
wN
wN
wN
wN
wN
wN
wN
wN
wN
wN
wN
wN
wN
wN
wN
wN
wN
"}
(50,1,1) = {"
wN
wN
wN
wN
wN
wN
wN
wN
wN
wN
wN
wN
wN
wN
wN
wN
wN
wN
wN
wN
wN
wN
wN
wN
wN
wN
wN
wN
wN
wN
wN
wN
wN
wN
wN
wN
wN
wN
wN
wN
wN
wN
wN
wN
wN
wN
wN
wN
wN
wN
wN
wN
wN
wN
wN
wN
wN
wN
wN
wN
wN
wN
wN
wN
wN
wN
wN
wN
wN
wN
wN
wN
wN
wN
wN
wN
wN
"}
(51,1,1) = {"
wN
wN
wN
wN
wN
wN
wN
wN
wN
wN
wN
wN
wN
wN
wN
wN
wN
wN
wN
wN
wN
wN
wN
wN
wN
wN
wN
wN
wN
wN
wN
wN
wN
wN
wN
wN
wN
wN
wN
wN
wN
wN
wN
wN
wN
wN
wN
wN
wN
wN
wN
wN
wN
wN
wN
wN
wN
wN
wN
wN
wN
wN
wN
wN
wN
wN
wN
wN
wN
wN
wN
wN
wN
wN
wN
wN
wN
"}
(52,1,1) = {"
wN
wN
wN
wN
wN
wN
wN
wN
wN
wN
wN
wN
wN
wN
wN
wN
wN
wN
wN
wN
wN
wN
wN
wN
wN
wN
wN
wN
wN
wN
wN
wN
wN
wN
wN
wN
wN
wN
wN
wN
wN
wN
wN
wN
wN
wN
wN
wN
wN
wN
wN
wN
wN
wN
wN
wN
wN
wN
wN
wN
wN
wN
wN
wN
wN
wN
wN
wN
wN
wN
wN
wN
wN
wN
wN
wN
wN
"}
(53,1,1) = {"
wN
wN
wN
wN
wN
wN
wN
wN
wN
wN
wN
wN
wN
wN
wN
wN
wN
wN
wN
wN
wN
wN
wN
wN
wN
wN
wN
wN
wN
wN
wN
wN
wN
wN
wN
wN
wN
wN
wN
wN
wN
wN
wN
wN
wN
wN
wN
wN
wN
wN
wN
wN
wN
wN
wN
wN
wN
wN
wN
wN
wN
wN
wN
wN
wN
wN
wN
wN
wN
wN
wN
wN
wN
wN
wN
wN
wN
"}
(54,1,1) = {"
wN
wN
wN
wN
wN
wN
wN
wN
wN
wN
wN
wN
wN
wN
wN
wN
wN
wN
wN
wN
wN
wN
wN
wN
wN
wN
wN
wN
wN
wN
wN
wN
wN
wN
wN
wN
wN
wN
wN
wN
wN
wN
wN
wN
wN
wN
wN
wN
wN
wN
wN
wN
wN
wN
wN
wN
wN
wN
wN
wN
wN
wN
wN
wN
wN
wN
wN
wN
wN
wN
wN
wN
wN
wN
wN
wN
wN
"}
(55,1,1) = {"
wN
wN
wN
wN
wN
wN
wN
wN
wN
wN
wN
wN
wN
wN
wN
wN
wN
wN
wN
wN
wN
wN
wN
wN
wN
wN
wN
wN
wN
wN
wN
wN
wN
wN
wN
wN
wN
wN
wN
wN
wN
wN
wN
wN
wN
wN
wN
wN
wN
wN
wN
wN
wN
wN
wN
wN
wN
wN
wN
wN
wN
wN
wN
wN
wN
wN
wN
wN
wN
wN
wN
wN
wN
wN
wN
wN
wN
"}
(56,1,1) = {"
wN
wN
wN
wN
wN
wN
wN
wN
wN
wN
wN
wN
wN
wN
wN
wN
wN
wN
wN
wN
wN
wN
wN
wN
wN
wN
wN
wN
wN
wN
wN
wN
wN
wN
wN
wN
wN
wN
wN
wN
wN
wN
wN
wN
wN
wN
wN
wN
wN
wN
wN
wN
wN
wN
wN
wN
wN
wN
wN
wN
wN
wN
wN
wN
wN
wN
wN
wN
wN
wN
wN
wN
wN
wN
wN
wN
wN
"}
(57,1,1) = {"
wN
wN
wN
wN
wN
wN
wN
wN
wN
wN
wN
wN
wN
wN
wN
wN
wN
wN
wN
wN
wN
wN
wN
wN
wN
wN
wN
wN
wN
wN
wN
wN
wN
wN
wN
wN
wN
wN
wN
wN
wN
wN
wN
wN
wN
wN
wN
wN
wN
wN
wN
wN
wN
wN
wN
wN
wN
wN
wN
wN
wN
wN
wN
wN
wN
wN
wN
wN
wN
wN
wN
wN
wN
wN
wN
wN
wN
"}
(58,1,1) = {"
wN
wN
wN
wN
wN
wN
wN
wN
wN
wN
wN
wN
wN
wN
wN
wN
wN
wN
wN
wN
wN
wN
wN
wN
wN
wN
wN
wN
wN
wN
wN
wN
wN
wN
wN
wN
wN
wN
wN
wN
wN
wN
wN
wN
wN
wN
wN
wN
wN
wN
wN
wN
wN
wN
wN
wN
wN
wN
wN
wN
wN
wN
wN
wN
wN
wN
wN
wN
wN
wN
wN
wN
wN
wN
wN
wN
wN
"}
(59,1,1) = {"
wN
wN
wN
wN
wN
wN
wN
wN
wN
wN
wN
wN
wN
wN
wN
wN
wN
wN
wN
wN
wN
wN
wN
wN
wN
wN
wN
wN
wN
wN
wN
wN
wN
wN
wN
wN
wN
wN
wN
wN
wN
wN
wN
wN
wN
wN
wN
wN
wN
wN
wN
wN
wN
wN
wN
wN
wN
wN
wN
wN
wN
wN
wN
wN
wN
wN
wN
wN
wN
wN
wN
wN
wN
wN
wN
wN
wN
"}
(60,1,1) = {"
wN
wN
wN
wN
wN
wN
wN
wN
wN
wN
wN
wN
wN
wN
wN
wN
wN
wN
wN
wN
wN
wN
wN
wN
wN
wN
wN
wN
wN
wN
wN
wN
wN
wN
wN
wN
wN
wN
wN
wN
wN
wN
wN
wN
wN
wN
wN
wN
wN
wN
wN
wN
wN
wN
wN
wN
wN
wN
wN
wN
wN
wN
wN
wN
wN
wN
wN
wN
wN
wN
wN
wN
wN
wN
wN
wN
wN
"}
(61,1,1) = {"
wN
wN
wN
wN
wN
wN
wN
wN
wN
wN
wN
wN
wN
wN
wN
wN
wN
wN
wN
wN
wN
wN
wN
wN
wN
wN
wN
wN
wN
wN
wN
wN
wN
wN
wN
wN
wN
wN
wN
wN
wN
wN
wN
wN
wN
wN
wN
wN
wN
wN
wN
wN
wN
wN
wN
wN
wN
wN
wN
wN
wN
wN
wN
wN
wN
wN
wN
wN
wN
wN
wN
wN
wN
wN
wN
wN
wN
"}
(62,1,1) = {"
wN
wN
wN
wN
wN
wN
wN
wN
wN
wN
wN
wN
wN
wN
wN
wN
wN
wN
wN
wN
wN
wN
wN
wN
wN
wN
wN
wN
wN
wN
wN
wN
wN
wN
wN
wN
wN
wN
wN
wN
wN
wN
wN
wN
wN
wN
wN
wN
wN
wN
wN
wN
wN
wN
wN
wN
wN
wN
wN
wN
wN
wN
wN
wN
wN
wN
wN
wN
wN
wN
wN
wN
wN
wN
wN
wN
wN
"}
(63,1,1) = {"
wN
wN
wN
wN
wN
wN
wN
wN
wN
wN
wN
wN
wN
wN
wN
wN
wN
wN
wN
wN
wN
wN
wN
wN
wN
wN
wN
wN
wN
wN
wN
wN
wN
wN
wN
wN
wN
wN
wN
wN
wN
wN
wN
wN
wN
wN
wN
wN
wN
wN
wN
wN
wN
wN
wN
wN
wN
wN
wN
wN
wN
wN
wN
wN
wN
wN
wN
wN
wN
wN
wN
wN
wN
wN
wN
wN
wN
"}
(64,1,1) = {"
wN
wN
wN
wN
wN
wN
wN
wN
wN
wN
wN
wN
wN
wN
wN
wN
wN
wN
wN
wN
wN
wN
wN
wN
wN
wN
wN
wN
wN
wN
wN
wN
wN
wN
wN
wN
wN
wN
wN
wN
wN
wN
wN
wN
wN
wN
wN
wN
wN
wN
wN
wN
wN
wN
wN
wN
wN
wN
wN
wN
wN
wN
wN
wN
wN
wN
wN
wN
wN
wN
wN
wN
wN
wN
wN
wN
wN
"}
(65,1,1) = {"
wN
wN
wN
wN
wN
wN
wN
wN
wN
wN
wN
wN
wN
wN
wN
wN
wN
wN
wN
wN
wN
wN
wN
wN
wN
wN
wN
wN
wN
wN
wN
wN
wN
wN
wN
wN
wN
wN
wN
wN
wN
wN
wN
wN
wN
wN
wN
wN
wN
wN
wN
wN
wN
wN
wN
wN
wN
wN
wN
wN
wN
wN
wN
wN
wN
wN
wN
wN
wN
wN
wN
wN
wN
wN
wN
wN
wN
"}
(66,1,1) = {"
wN
wN
wN
wN
wN
wN
wN
wN
wN
wN
wN
wN
wN
wN
wN
wN
wN
wN
wN
wN
wN
wN
wN
wN
wN
wN
wN
wN
wN
wN
wN
wN
wN
wN
wN
wN
wN
wN
wN
wN
wN
wN
wN
wN
wN
wN
wN
wN
wN
wN
wN
wN
wN
wN
wN
wN
wN
wN
wN
wN
wN
wN
wN
wN
wN
wN
wN
wN
wN
wN
wN
wN
wN
wN
wN
wN
wN
"}
(67,1,1) = {"
wN
wN
wN
wN
wN
wN
wN
wN
wN
wN
wN
wN
wN
wN
wN
wN
wN
wN
wN
wN
wN
wN
wN
wN
wN
wN
wN
wN
wN
wN
wN
wN
wN
wN
wN
wN
wN
wN
wN
wN
wN
wN
wN
wN
wN
wN
wN
wN
wN
wN
wN
wN
wN
wN
wN
wN
wN
wN
wN
wN
wN
wN
wN
wN
wN
wN
wN
wN
wN
wN
wN
wN
wN
wN
wN
wN
wN
"}
(68,1,1) = {"
wN
wN
wN
wN
wN
wN
wN
wN
wN
wN
wN
wN
wN
wN
wN
wN
wN
wN
wN
wN
wN
wN
wN
wN
wN
wN
wN
wN
wN
wN
wN
wN
wN
wN
wN
wN
wN
wN
wN
wN
wN
wN
wN
wN
wN
wN
wN
wN
wN
wN
wN
wN
wN
wN
wN
wN
wN
wN
wN
wN
wN
wN
wN
wN
wN
wN
wN
wN
wN
wN
wN
wN
wN
wN
wN
wN
wN
"}
(69,1,1) = {"
wN
wN
wN
wN
wN
wN
wN
wN
wN
wN
wN
wN
wN
wN
wN
wN
wN
wN
wN
wN
wN
wN
wN
wN
wN
wN
wN
wN
wN
wN
wN
wN
wN
wN
wN
wN
wN
wN
wN
wN
wN
wN
wN
wN
wN
wN
wN
wN
wN
wN
wN
wN
wN
wN
wN
wN
wN
wN
wN
wN
wN
wN
wN
wN
wN
wN
wN
wN
wN
wN
wN
wN
wN
wN
wN
wN
wN
"}
(70,1,1) = {"
wN
wN
wN
wN
wN
wN
wN
wN
wN
wN
wN
wN
wN
wN
wN
wN
wN
wN
wN
wN
wN
wN
wN
wN
wN
wN
wN
wN
wN
wN
wN
wN
wN
wN
wN
wN
wN
wN
wN
wN
wN
wN
wN
wN
wN
wN
wN
wN
wN
wN
wN
wN
wN
wN
wN
wN
wN
wN
wN
wN
wN
wN
wN
wN
wN
wN
wN
wN
wN
wN
wN
wN
wN
wN
wN
wN
wN
"}
(71,1,1) = {"
wN
wN
wN
wN
wN
wN
wN
wN
wN
wN
wN
wN
wN
wN
wN
wN
wN
wN
wN
wN
wN
wN
wN
wN
wN
wN
wN
wN
wN
wN
wN
wN
wN
wN
wN
wN
wN
wN
wN
wN
wN
wN
wN
wN
wN
wN
wN
wN
wN
wN
wN
wN
wN
wN
wN
wN
wN
wN
wN
wN
wN
wN
wN
wN
wN
wN
wN
wN
wN
wN
wN
wN
wN
wN
wN
wN
wN
"}
(72,1,1) = {"
wN
wN
wN
wN
wN
wN
wN
wN
wN
wN
wN
wN
wN
wN
wN
wN
wN
wN
wN
wN
wN
wN
wN
wN
wN
wN
wN
wN
wN
wN
wN
wN
wN
wN
wN
wN
wN
wN
wN
wN
wN
wN
wN
wN
wN
wN
wN
wN
wN
wN
wN
wN
wN
wN
wN
wN
wN
wN
wN
wN
wN
wN
wN
wN
wN
wN
wN
wN
wN
wN
wN
wN
wN
wN
wN
wN
wN
"}
(73,1,1) = {"
wN
wN
wN
wN
wN
wN
wN
wN
wN
wN
wN
wN
wN
wN
wN
wN
wN
wN
wN
wN
wN
wN
wN
wN
wN
wN
wN
wN
wN
wN
wN
wN
wN
wN
wN
wN
wN
wN
wN
wN
wN
wN
wN
wN
wN
wN
wN
wN
wN
wN
wN
wN
wN
wN
wN
wN
wN
wN
wN
wN
wN
wN
wN
wN
wN
wN
wN
wN
wN
wN
wN
wN
wN
wN
wN
wN
wN
"}
(74,1,1) = {"
wN
wN
wN
wN
wN
wN
wN
wN
wN
wN
wN
wN
wN
wN
wN
wN
wN
wN
wN
wN
wN
wN
wN
wN
wN
wN
wN
wN
wN
wN
wN
wN
wN
wN
wN
wN
wN
wN
wN
wN
wN
wN
wN
wN
wN
wN
wN
wN
wN
wN
wN
wN
wN
wN
wN
wN
wN
wN
wN
wN
wN
wN
wN
wN
wN
wN
wN
wN
wN
wN
wN
wN
wN
wN
wN
wN
wN
"}
(75,1,1) = {"
wN
wN
wN
wN
wN
wN
wN
wN
wN
wN
wN
wN
wN
wN
wN
wN
wN
wN
wN
wN
wN
wN
wN
wN
wN
wN
wN
wN
wN
wN
wN
wN
wN
wN
wN
wN
wN
wN
wN
wN
wN
wN
wN
wN
wN
wN
wN
wN
wN
wN
wN
wN
wN
wN
wN
wN
wN
wN
wN
wN
wN
wN
wN
wN
wN
wN
wN
wN
wN
wN
wN
wN
wN
wN
wN
wN
wN
"}
